// stemmed	representative
brave	brave
gilthoniel	gilthoniel
mountain-march	mountain-marches
sceptr	sceptre
twang	twang
clutter	cluttered
profession	professionally
treason	treason
fleshless	fleshless
befal	befall
silken	silken
bree-land	bree-land
lengthwi	lengthwis
event	event
slope	slope
cage	cage
evendim	evendim
jet	jet
steerless	steerless
!	!
'	'
parchment	parchments
answer	answered
regard	regarded
convul	convuls
.	.
meet	meet
narvi	narvi
o'er	o'er
,	,
steadi	steady
-	-
everwhit	everwhite
3	3
2	2
wetwang	wetwang
1	1
pastur	pastures
dawn	dawned
7	7
6	6
5	5
4	4
;	;
:	:
ageless	ageless
9	9
disast	disaster
8	8
encamp	encamped
eldamar	eldamar
?	?
derndingl	derndingle
sandheav	sandheaver
sped	sped
daze	dazed
gauntlet	gauntlets
biggest	biggest
estr	estre
watchmen	watchmen
penthous	penthouse
relief	relief
drip	dripping
otter	otter
entwash	entwash
embattl	embattled
narya	narya
f	f
happier	happier
g	g
d	d
e	e
b	b
muil	muil
c	c
`	`
crouch	crouched
thorin	thorin
a	a
n	n
yrch	yrch
purpl	purple
o	o
l	l
m	m
purpo	purpos
k	k
vagu	vaguely
h	h
calenardhon	calenardhon
i	i
w	w
v	v
u	u
t	t
s	s
r	r
stoningland	stoningland
p	p
reliev	relieved
y	y
sampl	sample
oromardi	oromardi
suspend	suspended
basin	basin
drop	drop
echo	echo
diner	diner
knobbl	knobbly
embalm	embalmed
jar	jars
targon	targon
samwi	samwis
hirluin	hirluin
jag	jagged
rebelli	rebellious
drow	drows
mightiest	mightiest
unrest	unresting
weari	weariness
spat	spat
unlov	unlovely
®	®
doubli	doubly
resist	resisted
unloo	unloos
much	much
jaw	jaw
timid	timid
mislead	mislead
muck	muck
column	columns
fewer	fewer
hedgerow	hedgerows
rammer	rammers
spar	spars
writ	writ
span	span
fladrif	fladrif
busybodi	busybody
watchman	watchman
espi	espied
lorien	lorien
generous	generous
twin	twin
wicker	wicker
entish	entish
yourselv	yourselves
declar	declared
ruthless	ruthless
flute	fluted
immens	immense
fuel	fuel
twig	twigs
wester	westering
sympathet	sympathetic
barker	barkers
confus	confusion
wicked	wickedness
orofarnl	orofarnl
suspens	suspense
hello	hello
shadowm	shadowmer
unfaith	unfaithful
which	which
wooden	wooden
flush	flushed
shadowi	shadowy
angrenost	angrenost
exhaust	exhausted
brown	brown
whirl	whirled
broth	broth
vani	vanis
rock	rock
surlili	surlily
rode	rode
glade	glade
hasti	hasty
border	borders
ishi	ishi
upturn	upturned
alight	alight
noiseless	noiseless
menn	menn
indign	indignant
outrun	outrunning
rascal	rascals
job	job
resign	resigned
dominion	dominion
robe	robed
scent	scent
rissk	rissk
regain	regains
mend	mending
scene	scenes
western	western
gblmud	gblmud
roam	roaming
embark	embarked
memo	memo
roar	roaring
muse	mused
joy	joy
thought	thought
dingl	dingle
palest	palest
road	road
space	space
celebrimbor	celebrimbor
jog	jogging
infuri	infuriate
careworn	careworn
cypress	cypress
rather	rather
waybread	waybread
cabbag	cabbages
melt	melted
sleepi	sleepiness
retort	retorted
spade	spade
cranni	crannied
celeborn	celeborn
bowmen	bowmen
furthest	furthest
exampl	example
alien	alien
laughter	laughter
fumbl	fumbled
overtak	overtake
wealthier	wealthier
bewitch	bewitched
spittl	spittle
beetl	beetles
monday	mondays
dernhelm	dernhelm
prai	prais
twos	twos
flung	flung
skewer	skewered
mess	mess
rogu	rogue
eight	eight
whine	whined
thorni	thorny
weather-beaten	weather-beaten
jig	jig
pray	pray
everi	every
mesh	mesh
wrap	wrapped
violenc	violence
plainer	plainer
andro	andros
vain	vain
spake	spake
mere	mere
violent	violently
merg	merged
purer	purer
cometh	cometh
braver	braver
chest	chests
campment	campment
armpit	armpit
thirteenth	thirteenth
ruffian	ruffianly
vale	vale
blossom	blossom
elsewher	elsewhere
while	while
dotag	dotage
declin	declining
errand	errand
drum	drums
valu	value
telcontar	telcontar
bowman	bowman
broom	broom
wellinghal	wellinghall
brook	brook
brood	brooding
instrument	instruments
isen	isen
bedridden	bedridden
bronz	bronze
fought	fought
brightest	brightest
taur-na-neldor	taur-na-neldor
zigil	zigil
forbidden	forbidden
thirteen	thirteen
telchar	telchar
replenish	replenished
appeas	appease
phial	phial
appear	appeared
furi	fury
wield	wield
captiv	captive
indispo	indispos
amethyst	amethyst
horribl	horrible
dismount	dismount
furl	furled
cave	cave
inaud	inaudible
windless	windless
kamanda	kamanda
although	although
shelter	shelter
Thursday	Thursday
drink	drink
potter	pottering
appeal	appealingly
sorceress	sorceress
lustili	lustily
throat	throat
conclav	conclave
October	October
cheat	cheat
sour	sour
dbin	dbin
isl	isle
advantag	advantage
snout	snout
soul	soul
iss	iss
prey	prey
suggest	suggested
soup	soup
contrapt	contraptions
warren	warren
shirriff	shirriffs
machineri	machinery
anborn	anborn
inatt	inattent
favor	favor
posit	positively
press	press
sort	sort
iron	iron
flower-garden	flower-garden
golasgil	golasgil
sore	sore
contrari	contrary
pippin	pippin
faintheart	fainthearted
dissip	dissipate
pinch	pinch
galdor	galdor
glanc	glance
oppon	opponents
oppos	oppose
snowi	snowy
ivi	ivy
d'you	d'you
tilth	tilth
apologet	apologetically
wrest	wrested
thicken	thickened
cara	caras
bowleg	bowlegged
gljowin	gljowine
smoulder	smouldering
thicket	thicket
thieveri	thievery
thump	thumped
spasm	spasm
must	must
thicker	thicker
assort	assortment
bower	bower
carn	carn
curious	curious
wither	withered
spars	sparsely
care	carefully
card	card
amidst	amidst
moist	moist
examin	examined
marshal	marshals
spare	sparing
carv	carved
rabbl	rabble
cart	cart
spark	sparks
iorla	iorlas
rumor	rumor
baldor	baldor
everlast	everlasting
cast	cast
paladin	paladin
ordeal	ordeal
case	case
thumb	thumb
cask	casks
hisself	hisself
oldest	oldest
vari	varied
song	song
uneasili	uneasily
garment	garments
greycloak	greycloaked
unlad	unlading
feebl	feeble
irk	irked
iri	iris
ghvn	ghvn
ish	ish
breach	breach
joyous	joyously
vast	vast
strenuous	strenuous
beneath	beneath
downland	downlands
helper	helper
overgrown	overgrown
strength	strength
soon	soon
torrent	torrent
gloomi	gloomy
tumbaletaurla	tumbaletaurla
caus	cause
replac	replaced
investig	investigating
gruffli	gruffly
eleventh	eleventh
giant	giants
eleventi	eleventy
undergrowth	undergrowth
grubb	grubbs
orthanc	orthanc
gimbatul	gimbatul
barazinbar	barazinbar
ilmarin	ilmarin
overcom	overcoming
rumbl	rumble
jest	jest
draw	draw
elevens	elevenses
camp	camped
spawn	spawned
rumba	rumba
drat	dratted
smudg	smudge
wordless	wordless
drive	drive
yourself	yourself
loseth	loseth
sole	sole
sold	sold
wrung	wrung
whiffl	whiffling
patern	paternal
unbuckl	unbuckled
culvert	culvert
some	some
grudg	grudgingly
stream	streamed
everywher	everywhere
scarlet	scarlet
backward	backwards
inhabit	inhabitants
berhael	berhael
buckleburi	bucklebury
beechbon	beechbone
resolut	resolutely
revers	reverse
straighten	straightened
eriador	eriador
straighter	straighter
undeserv	undeserved
prod	prodded
prow	prow
jerk	jerked
drag	dragging
hoist	hoisted
prop	propped
injuri	injury
remind	reminder
unimport	unimportant
spate	spate
brother	brothers
drab	drab
scrupul	scrupulous
snore	snoring
trumpet	trumpets
poignant	poignant
simbelmynl	simbelmynl
strange-look	strange-looking
mithlond	mithlond
andav	andave
contrast	contrast
grievanc	grievances
deadmen	deadmen
snort	snorted
nasti	nasty
cair	cair
surg	surge
drew	drew
sure	surely
cake	cakes
ringlu	ringlu
cheer	cheerful
babel	babel
chees	cheese
sloth	sloth
heedless	heedless
shiveri	shivery
headless	headless
seemeth	seemeth
cheek	cheek
greenish	greenish
streak	streaked
outsid	outside
pursu	pursued
determin	determined
beech	beech
golden	golden
interlac	interlacing
mymakil	mymakil
soil	soiled
calm	calm
call	call
soonest	soonest
unlid	unlidded
nestl	nestled
scrawni	scrawny
paper	papers
babbl	babbled
pillag	pillaging
starmoon	starmoon
rider	rider
unlit	unlit
virtu	virtue
full	full
unlik	unlike
glass	glass
temporari	temporary
meduseld	meduseld
erui	erui
sluggard	sluggard
reveng	revenge
sammi	sammie
check	checking
glare	glared
dreg	dregs
came	came
boorar	boorar
gorbadoc	gorbadoc
searcher	searchers
soft	softly
stalki	stalky
wraith	wraith
eclips	eclipse
mallorn-tr	mallorn-tre
furious	furious
unnecessarili	unnecessarily
centuri	century
pillar	pillars
twas	'twas
weighti	weighty
riddl	riddle
fume	fumes
blessed	blessedness
stuffi	stuffy
visit	visiting
lessen	lessen
wait	waiting
slipperi	slippery
mellon	mellon
lesser	lesser
wain	wains
andi	andy
wail	wailing
boar	boar
funni	funny
relentless	relentlessly
turnip	turnips
began	began
kin	kin
black	black
pimpl	pimple
lebethron	lebethron
smithi	smithies
discoveri	discovery
snakes	snakeses
jeopardi	jeopardy
further	further
soak	soaked
scintil	scintillating
impress	impression
soap	soap
soar	soaring
tunnel	tunnels
pillow	pillows
moodili	moodily
hungrili	hungrily
halifirien	halifirien
fern	fern
midday	midday
wage	wages
dark-ey	dark-eyed
everywh	everywher
waft	wafts
skirt	skirts
sunk	sunk
orcs	orcses
sung	sung
thou	thou
crotch	crotch
haldir	haldir
hottest	hottest
redhorn	redhorn
boat	boats
afflict	afflicted
sock	socks
embassi	embassy
encount	encounter
malinornjlion	malinornjlion
background	background
nothing	nothingness
weathertop	weathertop
sump	sump
bound	bound
marish	marish
hustl	hustled
ourselv	ourselves
haggard	haggard
outspread	outspread
undecid	undecided
enough	enough
bastion	bastion
mishap	mishap
kel	kel
rocket	rockets
ken	ken
wrench	wrenching
key	keys
''	''
possessor	possessor
eager	eagerness
cour	cours
script	scripts
eglerio	eglerio
bode	boding
fleet	fleets
bodi	bodies
ourself	ourselfs
sea-long	sea-longing
broach	broached
better	better
against	against
bendabl	bendable
sprout	sprout
angl	angle
walk	walked
wall	walls
involuntarili	involuntarily
sunken	sunken
ultim	ultimate
thatch	thatched
exhal	exhalation
sauron	sauron
yulma	yulma
wake	wake
unclos	unclosed
fiddlestick	fiddlesticks
salut	saluted
hardiest	hardiest
shaven	shaven
feud	feud
throng	throng
barer	barer
throne	throne
anew	anew
stonewright	stonewrights
suit	suit
fleck	flecked
lander	landers
they	they
fell	fell
premi	premis
wildest	wildest
baruk	baruk
nine	nine
pickthorn	pickthorn
ther	ther
halter	halter
unnam	unnamed
frosti	frosty
funer	funeral
wherev	wherever
edhellen	edhellen
thfn	thfn
swert	swertings
themselv	themselves
pestil	pestilence
swerv	swerved
eglantin	eglantine
ecthelion	ecthelion
lesson	lessons
wherea	whereas
unadorn	unadorned
deliveri	deliveries
earlier	earlier
skill	skill
them	them
overcam	overcame
then	then
thee	thee
dunghil	dunghill
'd	'd
wight	wights
daytim	daytime
everyon	everyone
riverland	riverlands
unmingl	unmingled
oliphaunts	oliphauntses
usual	usual
jacket	jacket
hotter	hotter
liveri	livery
disregard	disregard
oliphaunt	oliphaunts
larger	larger
stern	stern
rhosgobel	rhosgobel
envinyatar	envinyatar
snowbourn	snowbourn
's	's
within	within
plenti	plenty
maidchildren	maidchildren
'm	'm
eastfold	eastfold
second	second
snug	snug
snuf	snuffed
occupi	occupied
instruct	instructing
.1	.1
gather	gather
impregn	impregnable
childhood	childhood
doubl	doubled
everyth	everything
such	such
escort	escorted
doubt	doubt
suck	sucking
wade	wade
stuff	stuff
bough	boughs
anfala	anfalas
thin	thin
this	this
humpback	humpbacked
straggl	straggled
conclus	conclusion
fenc	fences
fend	fend
girth	girth
jostl	jostling
rnen	rnen
affect	affect
smaller	smaller
swept	swept
slither	slithering
waymeet	waymeet
purposeless	purposeless
stuck	stuck
various	various
mornil	mornil
colder	colder
anybodi	anybody
tindrock	tindrock
nightshad	nightshade
puissant	puissant
nardol	nardol
esteem	esteem
pester	pestered
edro	edro
--	--
suav	suave
felt	felt
loosen	loosened
quickword	quickworded
runner	runner
studi	study
grunt	grunted
fight	fight
braid	braids
quail	quailed
passer	passers
33	33
vanish	vanished
erech	erech
snow	snows
murmur	murmured
enorm	enormous
brain	brain
turn	turning
henceforward	henceforward
twilight	twilight
builder	builder
turf	turf
befor	before
huddl	huddled
ridden	ridden
upheld	upheld
windfola	windfola
afraid	afraid
wildberri	wildberries
shower	showers
disapprov	disapproval
enoug	enoug
deliber	deliberate
born	born
boro	boro
woollen	woollen
bore	bore
compuls	compulsion
11	11
12	12
nettl	nettles
terebinth	terebinth
habit	habitable
lightfoot	lightfooted
kinswoman	kinswoman
civil	civil
jut	jutting
fengel	fengel
stammer	stammered
nerveless	nerveless
erect	erect
boss	bosses
reviv	reviving
fault	fault
10	10
woodwright	woodwrights
whizz	whizzed
feat	feat
fear	fearfully
intrigu	intriguing
detail	details
confed	confeder
eyelid	eyelids
both	both
unread	unread
chessboard	chessboard
stunt	stunted
snla	snla
thag	thag
lichen	lichen
confer	confer
unreal	unreal
whisk	whisked
clamor	clamor
eldest	eldest
80	80
stung	stung
jug	jug
worthi	worthy
stump	stumps
white	white
that	that
princel	princeling
than	than
herugrim	herugrim
enquir	enquire
model	model
unmad	unmade
speechless	speechless
overthrown	overthrown
draught	draught
beater	beater
singer	singers
tusk	tusks
unmak	unmake
clammi	clammy
brace	braced
turv	turves
feed	feed
accent	accents
vaniti	vanity
feel	feel
bowl	bowls
proudfoot	proudfoot
speediest	speediest
feet	feet
descent	descent
masteri	mastery
unman	unmanned
hutch	hutch
derufin	derufin
distort	distorted
unmar	unmarred
beaten	beaten
whoever	whoever
articl	articles
circuit	circuit
descend	descended
relish	relish
tight	tight
malici	malicious
accept	accepted
confin	confines
ancient	ancient
whisper	whispered
lalla	lalla
unmov	unmoved
ankl	ankle
guild	guild
compens	compensated
nightfal	nightfall
boil	boiled
ward	ward
ware	ware
flesh	flesh
warg	wargs
seaward	seaward
orod	orod
snif	sniffing
anim	animals
handiwork	handiwork
wane	waned
pincer	pincers
wand	wand
westmanswe	westmansweed
usurp	usurpers
rowli	rowlie
lengthwis	lengthwise
latter	latter
length	length
want	wanted
wholli	wholly
steal	steal
twilit	twilit
confid	confidence
heaven	heavens
crisp	crisp
stub	stubbed
harmless	harmless
northfarth	northfarthing
dearer	dearer
stead	stead
anthil	anthills
unreckon	unreckoned
fruitless	fruitless
damag	damaged
cupboard	cupboard
stun	stunned
befit	befit
vehem	vehemence
brand	brands
stud	studded
stuf	stuffed
steam	steaming
bolt	bolt
overridden	overridden
enquiri	enquiry
ponder	pondered
anor	anor
bole	boles
accurs	accursed
bold	bold
stre	stre
anon	anon
unfriend	unfriendly
fortress	fortress
kingfish	kingfisher
offici	officially
custom	custom
mead	mead
thrown	thrown
succeed	succeeded
sooth	sooth
figur	figure
wandlimb	wandlimb
treasur	treasure
eddi	eddying
popular	popularly
wave	waves
hatch	hatched
properti	property
friend	friends
warn	warn
stop	stopped
warm	warm
enamour	enamoured
waterland	waterlands
bulli	bullies
-RRB-	-RRB-
wari	wary
harbour	harboured
orchestra	orchestra
stow	stowed
cring	cringed
pig-a-back	pig-a-back
bond	bond
lintl	lintl
nasturtium	nasturtiums
bone	bones
meat	meat
menurean	menureans
wash	washed
mean	mean
rhythm	rhythm
perturb	perturbed
boni	bony
envelop	envelope
pretti	pretty
distress	distress
brake	brakes
meal	meal
angelica	angelica
boot	boots
bulki	bulky
steed	steeds
matter	matter
revel	revel
steep	steep
steel	steel
unreason	unreason
ruler	ruler
wast	waste
distrust	distrusted
blacksmith	blacksmiths
inquir	inquire
rever	reverence
steer	steered
book	book
befel	befell
boom	boom
girdl	girdle
boon	boon
curunnr	curunnr
bright	bright
behav	behaved
uneven	uneven
noser	noser
tend	tended
bacon	bacon
spoke	spoke
gripe	griping
entwood	entwood
belfala	belfalas
tent	tent
tens	tense
tenn	tenn
these	these
erain	erain
precaut	precautions
ignor	ignorant
unbless	unblessed
pencil	pencils
rafter	raftered
discuss	discussed
faramir	faramir
bitter	bitterly
each	each
loathsom	loathsome
parth	parth
bitten	bitten
propos	proposal
myriad	myriads
parti	party
forgoil	forgoil
tree-slay	tree-slayer
mistaken	mistaken
warden	wardens
candlelight	candlelight
rival	rival
refrain	refrain
grievous	grievous
dishevel	dishevelled
goodby	goodbye
grind	grinding
twentyfirst	twentyfirst
popul	populous
foolhardi	foolhardy
oldbuck	oldbuck
tell	tell
hurri	hurried
merriment	merriment
goodbi	goodby
chamber	chamber
larder	larder
stir	stirred
messag	messages
wizen	wizened
hungri	hungry
weatherworn	weatherworn
slaver	slavering
gratifi	gratified
enchant	enchantment
hayfield	hayfields
ham	ham
retrac	retrace
undertak	undertake
hai	hai
sorceri	sorcery
hal	hal
postman	postman
har	harness
has	has
hat	hat
aboard	aboard
govannen	govannen
had	had
sweeten	sweetened
offens	offensive
lemba	lembas
hbl	hbl
herefara	herefara
topsid	topsides
sweeter	sweeter
seventh	seventh
seventi	seventy
rebuk	rebuked
eyehol	eyeholes
horseback	horseback
eagl	eagle
butterbur	butterbur
discern	discern
offenc	offence
offend	offended
hay	hay
dreamflow	dreamflower
tarmenel	tarmenel
ambaruna	ambaruna
knowledg	knowledge
unbidden	unbidden
unspoilt	unspoilt
kettl	kettle
gunwal	gunwale
lumpkin	lumpkin
wightish	wightish
chapter	chapter
nogothrim	nogothrim
parol	parole
mayhap	mayhap
long-expect	long-expected
spoil	spoiling
stubborn	stubbornly
tonight	tonight
onion	onions
quarrel	quarrels
music	music
unconqu	unconquered
coastland	coastlands
anbrion	anbrion
lothlurien	lothlurien
rowan	rowan
grist	grist
eastward	eastward
never	never
cerin	cerin
zag	zagging
there	there
haradrim	haradrim
stonewain	stonewain
motionless	motionless
govern	governing
singl	single
somehow	somehow
hee	hee
treacheri	treachery
hea	hea
westu	westu
houseless	houseless
unrecov	unrecover
hey	hey
hew	hewed
among	among
assault	assault
her	her
blown	blown
asham	ashamed
hen	hen
hem	hemmed
postmen	postmen
allianc	alliance
teen	teens
teem	teeming
voluntari	voluntary
warrior	warrior
sinew	sinews
outland	outlands
prattl	prattle
celebr	celebrating
mid-day	mid-day
thornbush	thornbushes
spout	spout
ladyship	ladyship
unshod	unshod
hospit	hospitality
innum	innumer
mithril	mithril
unless	unless
axe-bear	axe-bearer
griev	grieves
tracker	tracker
fredegar	fredegar
musti	musty
listen	listen
nambril	nambril
stay	staying
elven-riv	elven-river
star	stars
void	void
gangrel	gangrel
voic	voices
arwen	arwen
galleri	galleries
begun	begun
energet	energetic
bilbo	bilbo
unrust	unrusted
downstream	downstream
stab	stabbed
fenmarch	fenmarch
pawn	pawns
interior	interior
hid	hid
hip	hips
wisdom	wisdom
spoon	spoons
him	him
helmet	helmet
cooler	cooler
riderless	riderless
misgav	misgave
outcrop	outcrop
spook	spooks
his	his
hit	hits
tear	tears
unscath	unscathed
hir	hir
pave	paved
overtook	overtook
eorlinga	eorlingas
extrem	extremely
tribut	tribute
delver	delver
grimi	grimy
detach	detached
fatal	fatal
gaffer	gaffer
ashen	ashen
grime	grime
dinner	dinner
tortur	torture
discov	discover
wrinkl	wrinkled
paus	paused
misjudg	misjudged
owner	owner
musst	musst
commodi	commodious
ambush	ambush
praiseworthi	praiseworthy
ann-thennath	ann-thennath
homelik	homelike
digest	digesting
undaunt	undaunted
signatur	signatures
untruth	untruthfully
arrest	arrested
easi	easy
path	path
east	east
zig	zig
conqueror	conqueror
pate	pated
stew	stewed
outlast	outlast
sinist	sinister
your	your
agreement	agreement
sport	sport
bloom	bloom
creeper	creepers
past	past
pass	passed
botan	botanical
night	night
stem	stem
hemlock	hemlocks
earn	earned
fadeth	fadeth
step	step
anywher	anywhere
inattent	inattentive
swirl	swirled
nice	nice
parch	parched
tireless	tireless
hereaft	hereafter
weav	weave
underton	undertone
trickl	trickle
acrobat	acrobatics
monstrous	monstrous
witless	witless
tricki	tricky
blackhand	blackhanded
awaken	awakened
blameless	blameless
wallow	wallowing
vote	voted
headstal	headstall
anemon	anemones
absurd	absurd
doze	dozed
swarthi	swarthy
blood	blood
demon	demons
nick	nick
nich	niche
begon	begone
courteous	courteously
critic	critical
goe	goes
god	god
percept	perceptible
earthenwar	earthenware
haunt	haunts
wormtongu	wormtongue
madmen	madmen
aglarond	aglarond
wedg	wedge
sackvil	sackvill
surrend	surrender
springi	springy
evermind	evermind
elfhelm	elfhelm
springl	springle
valiant	valiant
weed	weed
sorri	sorry
satisfact	satisfaction
memoir	memoirs
exhibit	exhibited
weep	weeping
reckless	reckless
countrifi	countrified
lumber	lumber
ungraci	ungracious
rampant	rampant
down	down
borgil	borgil
week	week
nigh	nigh
rehear	rehears
strap	straps
splash	splash
straw	straw
grey-skin	grey-skinned
ballast	ballast
stray	stray
foreknowledg	foreknowledge
fireless	fireless
grief	grief
canker	canker
hilli	hilly
rebel	rebels
misgiv	misgives
control	control
sorti	sortie
meaningless	meaningless
prolong	prolonged
drench	drenched
thinner	thinner
thunderbolt	thunderbolt
elfston	elfstone
gor	gors
dour	dour
got	got
yestereven	yesterevening
meanwhil	meanwhile
struck	struck
introduc	introduced
grr	grr
dori	dori
collector	collector
flintheart	flinthearted
announc	announced
madman	madman
ashor	ashore
clearest	clearest
tricks	trickses
yoi	yoi
tharbad	tharbad
clumsili	clumsily
hill-top	hill-top
regret	regret
you	you
swish	swished
uncertainti	uncertainty
yon	yon
doth	doth
rejoic	rejoiced
tablet	tablets
actual	actually
weak	weak
weal	weal
latest	latest
wear	wear
weap	weap
rejoin	rejoin
unharm	unharmed
gui	guis
gamge	gamgee
estat	estates
rover	rover
shadow	shadows
gum	gum
frugal	frugal
oiall	oiall
numer	numerous
befallen	befallen
candl	candle
frjawin	frjawine
famousest	famousest
incalcul	incalculable
earthier	earthier
inspect	inspection
unprotect	unprotected
disconcert	disconcerting
block	blocked
thenc	thence
swordsmen	swordsmen
dispirit	dispirited
contriv	contrived
uprais	upraised
bowshot	bowshot
jewel	jewels
valinorean	valinorean
wilderland	wilderland
vanimar	vanimar
just	just
ridicul	ridiculous
fifth	fifth
troublesom	troublesome
gut	gut
anguish	anguish
fifti	fifty
tarnish	tarnish
conquest	conquest
sentinel	sentinel
swift	swiftly
discomfort	discomfort
simpl	simple
amongst	amongst
unnot	unnoticed
juli	juli
travel	travels
bloat	bloated
bottl	bottle
unpopular	unpopular
mysteri	mysteriously
weregild	weregild
lumbul	lumbull
swing	swinging
swine	swine
cruelli	cruelly
hurtl	hurtling
presum	presume
sssh	sssh
elanor	elanor
paint	painted
strip	strips
dreamless	dreamless
homestead	homesteads
jump	jumped
unconcern	unconcernedly
traver	travers
tintilar	tintilar
furnac	furnaces
tasarinan	tasarinan
cesspool	cesspool
presto	presto
june	june
north	north
fatti	fatty
firesid	fireside
burrow	burrows
ssss	ssss
misfortun	misfortune
exist	existence
edrello	edrello
smoke-r	smoke-r
leadership	leadership
rampart	rampart
afoot	afoot
splayf	splayfing
\*	\*
hobbit	hobbits
begin	beginning
blunder	blunder
\/	\/
tower	tower
organ	organ
towel	towels
abyss	abyss
riven	riven
their	their
river	river
auction	auction
crockeri	crockery
solemn	solemnly
said	said
ghost	ghostly
lord	lord
glaze	glazed
lore	lore
deed	deed
childish	childish
pikestaff	pikestaff
deem	deem
fr	fr
sail	sails
jeer	jeered
ft	ft
deep	deep
lockhol	lockholes
breath	breath
deer	deer
sharkey	sharkey
uninvit	uninvited
plate	plate
overlaid	overlaid
he	he
murki	murky
tradit	tradition
ha	ha
betray	betrayed
confess	confessed
breast	breast
i.	i.
magic	magic
cauldron	cauldron
gi	gi
eastfarth	eastfarthing
flagon	flagon
go	going
yea	yea
mirrormer	mirrormere
du	du
sage	sages
gift	gifts
idea	idea
superior	superior
dy	dyed
lope	loping
servant	servants
ea	eas
eb	ebbing
deplor	deploring
unweari	unwearied
lieuten	lieutenant
deci	decis
loot	loot
di	di
presid	presiding
saruman	saruman
loop	loops
do	do
minstrel	minstrels
loos	loose
deck	deck
loom	looming
loon	loon
dr	dr
look	looking
safe	safe
farmhous	farmhouse
debt	debt
wreck	wreck
ngurutho	nguruthos
cracker	cracker
fa	fa
rivendel	rivendell
forgav	forgave
needl	needles
fe	fe
yes	yes
eh	eh
succor	succor
barley	barley
ee	ee
el	els
newer	newer
en	en
hardbottl	hardbottle
em	'em
et	et
yew	yew
airetbri	airetbri
er	er
g3	g3
yet	yet
tinkl	tinkling
strung	strung
ca	ca
player	players
frodo	frodo
quiver	quiver
possibl	possible
ithil	ithil
lone	lonely
by	by
dear	dear
southfarth	southfarthing
long	long
br	br
bu	bu
wallet	wallet
situat	situation
perchanc	perchance
deal	deals
precip	precipic
sprinter	sprinter
eavesdrop	eavesdropping
arvernien	arvernien
dead	dead
bc	bc
be	be
gild	gilded
opal	opal
flavor	flavor
befriend	befriend
trestl	trestles
sinuous	sinuous
vault	vaults
itch	itch
holiday	holiday
loll	lolling
co	co
lighten	lighten
ch	ch
collect	collection
swordsman	swordsman
mushroom	mushrooms
depress	depressed
doer	doer
moth-bal	moth-balls
boast	boast
riverward	riverward
displeas	displeased
colon	colonized
lighter	lighter
chisel	chisel
recommend	recommended
notch	notched
sack	sacks
oblig	obliged
ici	icy
ice	ice
restraint	restraint
``	``
sacr	sacred
enfold	enfolding
quarri	quarried
ay	ay
cram	cram
entwiv	entwives
at	at
cruelti	cruelty
as	as
ar	ar
crag	crags
handstrok	handstrokes
idl	idle
trophi	trophies
tingl	tingled
ai	ai
judg	judge
dodg	dodged
color	color
melui	melui
am	am
entwif	entwife
an	an
surcoat	surcoats
mindless	mindless
ad	added
caper	capering
sabl	sable
ah	ah
forget	forgetting
growth	growth
sancho	sancho
nu	nu
tranc	trance
memori	memory
stamped	stampede
no	no
door	door
iii	iii
forgotten	forgotten
bother	bothering
doom	doom
of	of
realm	realm
shirrif	shirriffing
feast	feasting
oblong	oblong
prosper	prospered
on	on
perceiv	perceive
oi	oi
deni	deny
tramp	tramping
knob	knob
oh	oh
dell	dell
ot	ot
dong	dong
or	or
cliff	cliff
done	done
delv	delved
captor	captors
ox	ox
board	board
commend	commend
pursuit	pursuit
ow	ow
earthquak	earthquake
newli	newly
lamplit	lamplit
pa	pa
cavalcad	cavalcade
battl	battle
lamplik	lamplike
po	po
delay	delayed
comment	comment
small	small
listless	listlessly
plant	planted
lo	lo
squeez	squeezed
ll	'll
strain	strain
rohan	rohan
crew	crew
click	clicked
plank	plank
banish	banished
totter	tottering
untidi	untidy
eyeless	eyeless
somersault	somersault
ma	ma
dora	dora
me	me
presag	presage
engraven	engraven
porch	porch
ml	ml
mi	mi
seventeen	seventeen
mr	mr
purchas	purchase
fornost	fornost
mw	mw
my	my
crea	creas
digniti	dignity
na	na
nb	nb
item	item
ng	ng
ni	ni
gilrain	gilrain
puff	puffs
nl	nl
apac	apace
reveal	revealed
imp	imps
bracken	bracken
spinney	spinney
cousin	cousins
suspici	suspicious
bracket	brackets
notic	noticed
night-hour	night-hours
love	love
outfli	outfly
ind	inde
trail	trail
train	train
captur	capture
gatekeep	gatekeepers
inn	inn
pursuer	pursuers
bullroar	bullroarer
favorit	favorite
hadst	hadst
unbind	unbind
finrod	finrod
dryad	dryad
ink	ink
bewar	beware
loud	loudly
le	le
separ	separate
unrecover	unrecoverable
anann	anann
la	la
perpetu	perpetual
nobil	nobility
agoni	agony
degr	degre
lost	lost
loss	loss
hu	hued
dome	domes
footprint	footprints
drift	drifting
blur	blurred
hi	hi
ho	ho
hm	hm
queerest	queerest
loth	loth
enrag	enrage
fiftieth	fiftieth
if	if
diamond	diamonds
plash	plashing
gravest	gravest
is	is
twenti	twenties
entwad	entwade
it	it
potent	potent
ill	ill
afternoon	afternoon
iv	iv
defi	defying
ii	ii
drier	drier
harbourless	harbourless
smash	smash
weakest	weakest
dole	doled
know	know
in	in
rapid	rapids
knot	knot
lose	losing
potenc	potency
l'	l'
squeal	squeal
merethrond	merethrond
squeak	squeak
whiteskin	whiteskins
linnathon	linnathon
blue	blue
mirkwood	mirkwood
remonstr	remonstrance
smart	smart
greater	greater
bootless	bootless
bearabl	bearable
strand	stranded
strang	strange
knew	knew
spot	spot
drainag	drainage
orcrist	orcrist
smaug	smaug
hador	hador
evernight	evernight
jerkin	jerkin
forgot	forgot
sleepless	sleepless
place	place
serious	serious
knee	knees
slack	slack
devi	devis
wi	wi
rohirrim	rohirrim
inglorion	inglorion
loav	loaves
how	how
hoy	hoy
wo	wo
cling	clinging
farm-household	farm-household
loan	loan
ioreth	ioreth
clink	clinking
warbl	warbling
glamdr	glamdring
pure	pure
hom	hom
trinket	trinket
hog	hog
loaf	loaf
unhurt	unhurt
hoi	hoi
hot	hot
load	load
wa	wa
flabbergast	flabbergasted
hoo	hoo
hop	hop
readi	ready
we	we
hor	hors
wisest	wisest
climb	climb
grandfath	grandfather
blackroot	blackroot
eventu	eventually
give	giving
westgat	westgate
lnrinen	lnrinen
desi	desi
vi	vi
pimpli	pimply
edrnur	edrnur
descri	descried
harken	harken
dragonet	dragonets
hob	hob
brought	brought
clime	clime
window-pan	window-panes
havoc	havoc
hindmost	hindmost
chestnut	chestnut
chalki	chalky
ve	've
frond	fronds
inadequ	inadequate
outstay	outstayed
shrieker	shriekers
gorbag	gorbag
scratch	scratch
rivalri	rivalry
outward	outwardly
previous	previously
ug	ugli
yale	yale
wheedl	wheedling
front	front
retir	retired
us	us
pare	paring
ut	ut
un	un
tripl	triple
up	up
sinom	sinome
field	fields
orphan	orphan
tw	tw
weapon	weapons
hmm	hmm
part	parting
gentlehobbit	gentlehobbit
squirrel	squirrel
to	to
plagu	plague
weedi	weedy
flinch	flinched
wareh	warehous
wearisom	wearisome
hug	hugging
cloudless	cloudless
hue	hue
pull	pulled
wizardri	wizardry
frost	frost
variag	variags
crow	crow
te	te
round	round
bathroom	bathroom
signifi	signifies
crop	crop
th	th
urchin	urchins
amount	amount
embrac	embraced
variat	variations
ta	ta
su	su
uphil	uphill
knit	knit
froth	frothing
liabl	liable
sulkili	sulkily
st	st
lindelorendor	lindelorendor
senseless	senseless
sn	sn
sneakthief	sneakthief
submit	submit
sp	sp
so	so
pump	pump
effort	effort
pale	pale
se	se
sh	sh
si	si
palm	palm
rz	rz
spun	spun
pall	pall
sa	sa
house-dwel	house-dwellers
spur	spurred
elvendom	elvendom
bundl	bundles
ry	ry
birthday	birthday
ro	ro
unfasten	unfastened
hammerhand	hammerhand
plait	plaited
hsh	hsh
mishandl	mishandled
re	're
gerontius	gerontius
reach	reached
ra	ra
qu	qu
bunch	bunched
qs	qs
lengthen	lengthened
plain	plain
dens	dense
maidchild	maidchild
dent	dent
consult	consulting
ladder	ladder
strawhead	strawheads
retel	retell
foggi	foggy
delib	deliber
trace	traced
oppo	oppos
ungoli	ungoliant
unbreak	unbreakable
track	track
isenmouth	isenmouthe
pane	panes
outfal	outfall
pant	panted
school	school
deliv	deliver
radagast	radagast
pr	pr
ps	ps
subterranean	subterranean
test	test
guardian	guardian
insist	insist
shrank	shrank
whether	whether
open	open
midnight	midnight
page	page
margin	margins
essay	essays
brutal	brutal
stealthi	stealthy
fieri	fiery
twinkl	twinkle
delta	delta
yawn	yawned
fierc	fiercely
retch	retched
warfar	warfare
extinguish	extinguished
oakenshield	oakenshield
delud	deluded
tomorrow	tomorrow
forgiv	forgive
pair	pairs
balust	balusters
pain	painful
squander	squandered
issu	issued
stricken	stricken
fastr	fastred
paid	paid
firienfeld	firienfeld
southern	southern
spit	spitted
-lrb-	-lrb-
loft	loft
litter	littered
spin	spinning
fingertip	fingertips
hum	hum
spear	spear
foothil	foothills
hut	hut
mayor	mayor
profound	profound
haven	haven
speak	speaking
frown	frowning
coverlet	coverlet
shabbier	shabbier
should	should
rootlik	rootlike
cormacolindor	cormacolindor
stoneh	stonehous
goblin	goblins
twain	twain
retak	retake
walker	walkers
attack	attack
unshap	unshaped
pace	pace
lode	lodes
lodg	lodge
outpost	outposts
beaklik	beaklike
bosom	bosom
gorhendad	gorhendad
pack	packed
yuldar	yuldar
though	though
urgenc	urgency
fisher	fisher
proper	proper
legola	legolas
treebeard	treebeard
irresist	irresistibly
rough	roughly
appl	apples
contain	contain
avalanch	avalanche
plantat	plantations
bearer	bearer
luini	luini
yard	yards
object	objected
goblet	goblet
push	pushed
clipp	clippely
escap	escape
vintag	vintage
greybeard	greybeards
Decemb	December
juggler	juggler
purs	purse
dwimorberg	dwimorberg
froze	froze
hapless	hapless
dewi	dewy
monument	monument
gird	gird
elf-friend	elf-friend
ye	ye
etten	etten
error	error
ya	ya
urgent	urgently
lock	lock
girt	girt
nearest	nearest
waylaid	waylaid
armour	armourer
term	terms
strategi	strategy
poorer	poorer
yo	yo
secret	secret
disappear	disappearance
yj	yj
jester	jester
1419	1419
1418	1418
goldilock	goldilocks
shatter	shatter
1417	1417
workmen	workmen
provend	provender
novemb	novemb
athela	athelas
contributor	contributor
overhil	overhill
banquet	banquet
treacher	treacherous
trick	trick
luxuri	luxury
brandywin	brandywine
1420	1420
upris	uprising
1421	1421
unchang	unchanged
crook	crookedly
comic	comic
thjodr	thjodred
clearer	clearer
sequel	sequel
fey	fey
whortleberri	whortleberry
few	few
fed	fed
slightest	slightest
fen	fen
leer	leering
gluin	gluin
precipic	precipice
vivid	vivid
made	made
phalanx	phalanx
undercut	undercut
signboard	signboard
periain	periain
token	token
trial	trials
lagduf	lagduf
overburden	overburdened
tribe	tribes
ledg	ledges
enjoy	enjoyed
unabl	unable
unthank	unthanked
strongest	strongest
feign	feigned
guess	guessed
guest	guests
nowaday	nowadays
merrier	merrier
garner	garner
fabul	fabulously
rumello	rumello
laituvalmet	laituvalmet
garnet	garnets
unsling	unslinging
lead	leading
spoken	spoken
leaf	leaf
ossir	ossir
unchart	uncharted
witch	witches
burnish	burnished
fax	fax
sallow	sallow
luck	luck
fat	fat
far	far
label	label
display	displays
insecur	insecurity
fan	fanned
borrow	borrower
fal	fals
lean	leaning
fag	fag
leak	leaked
fac	fac
leav	leave
obscur	obscure
draweth	draweth
gobbler	gobbler
make	make
leap	leaping
misunderstood	misunderstood
feroci	ferocious
breech	breeches
indoor	indoors
occasion	occasionally
lavish	lavishly
approv	approving
glen	glen
gradual	gradually
vedui	vedui
glea	glea
asid	aside
carcanet	carcanet
mail	mail
silvertin	silvertine
heavier	heavier
maim	maimed
main	mainly
phew	phew
southernmost	southernmost
trifl	trifle
dwarrowdelf	dwarrowdelf
maid	maids
eleventy-first	eleventy-first
enliven	enliven
unmistak	unmistakable
glow	glowing
moontow	moontower
obvious	obviously
inva	invas
woodhal	woodhall
report	reported
carrier	carriers
scorch	scorched
shrunk	shrunk
glede	glede
invi	invis
loneli	loneliness
devot	devoted
forehead	forehead
manwis	manwise
asla	asla
brockenbor	brockenbores
phantom	phantom
compo	compos
unpeopl	unpeopled
mischief	mischief
umbel	umbels
nvla	nvla
dnriel	dnriel
lordl	lordlings
finest	finest
whitest	whitest
greatheart	greatheart
narsil	narsil
build	building
unawar	unawares
jomund	jomund
displea	displeas
adjust	adjusted
triumphant	triumphantly
palan	palan
flounder	flounder
built	built
gestur	gesture
unimagin	unimaginable
smallest	smallest
penetr	penetrating
fourth	fourth
dolven	dolven
club	clubs
anigh	anigh
unclear	unclear
unclean	unclean
midst	midst
comprehen	comprehens
penni	penny
croak	croak
beast	beasts
penna	penna
almost	almost
waken	waken
retreat	retreat
permiss	permission
carriag	carriages
froglik	froglike
howev	however
eye	eye
fineri	finery
inrush	inrush
punch	punch
januari	januari
curios	curiosity
mace	mace
dress	dressed
umbar	umbar
norland	norland
insupport	insupportable
formless	formless
clop	clop
scale	scales
noisili	noisily
crock	crocks
trouser	trouser
agricultur	agricultural
paler	paler
forsaken	forsaken
foresaw	foresaw
baldric	baldric
scalp	scalp
mitheithel	mitheithel
into	into
produc	produces
tumbalemorna	tumbalemorna
anxious	anxious
taurelilumla	taurelilumla
gollum-lik	gollum-like
recaptur	recapture
brazen	brazen
glob	glob
primev	primeval
beard	beard
gleam	gleaming
glean	gleaned
fester	festers
increa	increas
misunderstand	misunderstanding
blunt	blunted
mnriel	mnriel
blew	blew
condescend	condescending
damrod	damrod
brandybuck	brandybuck
diseas	diseased
darkl	darkling
majesti	majesty
countrysid	countryside
ewer	ewer
tipsi	tipsy
corsair	corsairs
burrows	burrowses
tapestri	tapestries
zvram	zvram
eve	eve
broader	broader
leathern	leathern
visibl	visible
eva	evas
corridor	corridor
broaden	broadened
maul	mauled
thankless	thankless
strike	strike
tipto	tiptoed
meneldil	meneldil
grimbeorn	grimbeorn
written	written
dubious	dubiously
repriev	reprieved
mauh	mauh
thirsti	thirsty
bewilder	bewilderment
oiolosslo	oiolosslo
outskirt	outskirts
matt	matte
young	young
alter	altering
longbottom	longbottom
skai	skai
narrow	narrow
mate	mate
welter	welter
misdoubt	misdoubt
withdrawn	withdrawn
leafless	leafless
obstin	obstinate
perform	perform
dumbfound	dumbfounded
parsley	parsleys
fan-progress	fan-progress
miseri	misery
vanimblion	vanimblion
palac	palaces
requir	require
unhappi	unhappy
farse	farseeing
blin	blin
carpent	carpenter
grandchildren	grandchildren
dunland	dunland
glitter	glittered
tree-trunk	tree-trunk
chink	chinks
freeli	freely
youth	youth
scarv	scarves
scari	scary
alder	alder
elven-r	elven-rings
sharer	sharers
scarc	scarce
shoreless	shoreless
scarf	scarf
scare	scared
robberi	robbery
uproar	uproar
legal	legal
famous	famous
ere	ere
cloak	cloak
deplet	depleted
unlearn	unlearned
esquir	esquire
maze	maze
child	child
gate-keep	gate-keeper
precious	precious
multipli	multiply
question	question
pilgrim	pilgrim
ferri	ferry
recount	recounted
chill	chill
mayb	maybe
farth	farthings
effect	effect
spurn	spurning
spurt	spurt
strife	strife
glut	glut
eclip	eclips
beckon	beckoned
meneldor	meneldor
mortal	mortally
nothin	nothin
stare	staring
stark	stark
starl	starling
sterner	sterner
leggi	leggy
gainsaid	gainsaid
goldb	goldbe
elf	elf
wiser	wiser
mani	many
troubl	trouble
elm	elm
sputter	sputtered
mane	mane
ell	ell
describ	described
again	again
stride	stride
elv	elves
els	else
solid	solid
flanor	flanor
bifur	bifur
elw	elwing
starv	starving
covert	covert
start	start
prize	prize
strict	strict
knive	knives
labori	laboriously
filth	filth
postscript	postscript
uncount	uncounted
tempest	tempest
boulder	boulders
valley	valley
daylong	daylong
blanket	blankets
galathilion	galathilion
upset	upset
casual	casual
gorgor	gorgor
nimrai	nimrais
district	district
watcher	watchers
end	end
hornblast	hornblasts
feint	feint
shudder	shuddered
southron	southrons
mutter	muttered
woven	woven
ninni	ninny
bloodi	bloody
anvil	anvil
uproot	uprooted
ent	ents
wrought	wrought
blush	blushed
archer	archers
beechen	beechen
archet	archet
malt	malt
straightway	straightway
torech	torech
alreadi	already
ferni	ferny
merrili	merrily
moonbeam	moonbeams
skil	skilfully
mask	masked
beach	beaches
mithrandir	mithrandir
skip	skipped
egg	egg
skin	skins
mass	mass
mast	mast
stave	staves
enslav	enslaved
uncouth	uncouth
aldor	aldor
bidden	bidden
dearest	dearest
chief	chief
tenth	tenth
mare	mare
unshapen	unshapen
scoundrel	scoundrels
wri	wry
dream	dream
onward	onward
ablaz	ablaze
mark	mark
comer	comers
marg	marges
drear	drear
ninth	ninth
willow-tre	willow-tree
kindler	kindler
strawber	strawber
raiment	raiment
fountain	fountains
blot	blotting
woe	woe
trough	trough
servitud	servitude
state	state
inde	indeed
quench	quench
forsook	forsook
flappi	flappy
adventur	adventure
wou	wou
flatten	flattened
leader	leader
wor	wors
billow	billows
middl	middle
magician	magician
leaden	leaden
won	won
ripen	ripening
blow	blow
plunder	plundered
flatter	flattered
boffin	boffins
imlad	imlad
inch	inch
vision	visions
lubber	lubber
engulf	engulf
surpass	surpassed
bollard	bollards
address	addressed
infect	infection
craven	craven
special	special
statu	statues
need	need
menor	menor
seren	serene
brazier	brazier
decreas	decrease
arch	arches
benefit	benefits
fish	fish
brethren	brethren
dainti	dainty
neek	neek
narchost	narchost
1311	1311
likeliest	likeliest
ordinari	ordinary
over	over
bleak	bleak
conin	conin
gorgyn	gorgyn
blear	bleared
naught	naught
bleat	bleating
well-plea	well-pleas
heaviest	heaviest
graze	grazing
carnimnril	carnimnril
unrip	unripe
number	number
resembl	resemble
attract	attracted
conic	conical
smoke	smoking
gil	gil
gim	gimli
smoki	smoky
overhang	overhanging
fist	fist
arag	arag
carrot	carrots
brego	brego
screw	screws
jowyn	jowyn
immen	immens
finduila	finduilas
arisen	arisen
stake	stake
ciril	ciril
treeless	treeless
walda	walda
forestri	forestry
wer	wer
especi	especially
wet	wet
toler	tolerant
swamp	swamps
scree	screes
thorough	thoroughly
ensnar	ensnared
stair	stair
vanguard	vanguard
firm	firmly
wed	wed
abid	abide
forgiven	forgiven
web	web
o'clock	o'clock
protrud	protrude
overhung	overhung
stain	stained
fire	fire
louder	louder
breez	breeze
araw	araw
scimitar	scimitars
ceaseless	ceaselessly
bolster	bolster
postpon	postpone
hardest	hardest
russet	russet
clever	clever
intaken	intaken
ryna	ryna
behalf	behalf
headlong	headlong
wha	wha
breed	breed
argu	argue
whe	whe
circl	circle
ossiriand	ossiriand
whi	why
breek	breek
abat	abated
who	who
close	close
imprint	imprint
upsid	upside
opinion	opinion
oval	oval
tickl	tickle
horsemast	horsemaster
renown	renowned
midgewat	midgewater
gen	gen
unrel	unrelated
get	get
finder	finder
unrev	unrevealed
grave	grave
guidanc	guidance
slinker	slinker
elixir	elixirs
bracelet	bracelet
khand	khand
pictur	pictures
frogmorton	frogmorton
gee	gees
near	near
neat	neatly
tiresom	tiresome
audienc	audience
stalk	stalked
gem	gems
boundari	boundary
gel	gel
byword	byword
stale	stale
renounc	renounce
neck	neck
former	former
throw	throw
wit	witnesses
immin	imminent
fragment	fragment
throe	throes
stamp	stamped
hiding-plac	hiding-place
orodruin	orodruin
five	five
throb	throbbing
rehears	rehearsed
roast	roast
win	win
wil	wilful
vanimelda	vanimelda
stand	standing
mission	mission
interfer	interfere
rippl	ripples
accustom	accustomed
handkerchief	handkerchiefs
odour	odour
stank	stank
ortanl	ortanl
stomach	stomach
sorrow	sorrowful
emblem	emblems
dung	dung
dune	dunes
ostler	ostler
bandi	bandy
flurri	flurry
hearest	hearest
nighting	nightingal
break	breaking
emerald	emerald
bread	bread
pelennor	pelennor
swath	swathed
benevol	benevolent
youngest	youngest
dappl	dappled
import	important
immov	immovable
central	central
knife	knife
ring	ringing
screen	screened
fetch	fetch
gag	gagged
gah	gah
rins	rinse
morrow	morrow
prime	prime
gar	gar
traffic	traffic
skinbark	skinbark
abod	abode
gay	gay
sorcer	sorcerer
thwart	thwart
gan	gan
rind	rind
gap	gap
unseen	unseen
caller	callers
haughti	haughty
talent	talent
arid	arid
riot	riot
closet	closeted
abov	above
protect	protection
closer	closer
loudwat	loudwater
puddl	puddle
stabl	stable
louver	louver
turbul	turbulent
aris	arise
dizzi	dizzy
similar	similar
clock	clocks
quicker	quicker
menelvagor	menelvagor
quicken	quickening
hayward	hayward
sparrow	sparrow
flight	flight
remaind	remainder
ripe	ripe
imposs	impossible
galadhremmin	galadhremmin
calembel	calembel
zirak	zirak
enlighten	enlighten
dure	during
beleagu	beleaguered
arod	arod
dwarf-fashion	dwarf-fashion
woodcraft	woodcraft
menorean	menorean
aros	arose
champion	champions
lettuc	lettuce
22nd	22nd
tasarion	tasarion
dusk	dusk
fangorn	fangorn
opportun	opportunity
maruvan	maruvan
dust	dust
nurseri	nursery
thrur	thrur
pleasur	pleasure
apiec	apiece
stack	stacked
liken	liken
pilgrimag	pilgrimage
cotton	cotton
armi	armies
eilenach	eilenach
accomplish	accomplish
wan	wan
diriel	diriel
duti	duty
mablung	mablung
caita	caita
wax	waxed
way	way
sward	sward
wat	wat
stage	stage
war	war
was	was
risk	risk
staff	staff
driven	driven
rise	rising
haggl	haggling
nimbl	nimbly
withstood	withstood
powerless	powerless
driver	drivers
swart	swart
hopeless	hopeless
princ	princes
swarm	swarming
hovel	hovels
vieni	vieny
deepi	deepi
standard	standards
hover	hovered
print	prints
vieny	vienyes
ghast	ghastly
bleed	bleeding
wag	wag
wellingh	wellinghal
cairn	cairn
yestr	yestre
garland	garlands
untrodden	untrodden
wad	wad
imrahil	imrahil
wood	woods
blemish	blemish
lure	lure
tallest	tallest
advis	advise
scrub	scrubbed
pride	pride
kinsmen	kinsmen
danger	danger
slipper	slippers
forward	forward
flake	flakes
wanton	wanton
evas	evasively
wool	wool
advic	advice
cottag	cottage
instinct	instinct
villag	village
hagl	hagling
neighborhood	neighborhood
swagger	swagger
limeston	limestone
moonlight	moonlight
graveyard	graveyard
brunt	brunt
price	prices
wont	wont
prick	pricked
oakwood	oakwoods
haft	haft
breakfast	breakfast
next	next
defen	defens
tussl	tussle
unchalleng	unchallenged
nuncl	nuncle
paddl	paddles
fur	fur
damask	damasked
chamberlain	chamberlain
everard	everard
caught	caught
northerland	northerland
hair	hair
resent	resented
gandalf	gandalf
forestal	forestall
menac	menacing
hail	hail
farewel	farewells
news	news
rift	rift
manger	manger
galad	galad
steadier	steadier
vulgar	vulgar
familiar	familiar
lune	lune
lung	lung
obedi	obedience
luni	luni
fring	fringes
afield	afield
muddi	muddy
squar	square
facet	facets
breadth	breadth
lithui	lithui
squat	squatted
muddl	muddled
inner	inner
oblivion	oblivion
lithlad	lithlad
hostag	hostages
morsel	morsel
faithless	faithless
woke	woke
hack	hacked
stonili	stonily
waterman	waterman
betid	betide
taken	taken
lugga	lugga
bruis	bruised
trodden	trodden
victim	victim
signific	significant
ful	fulness
nonsens	nonsense
fun	fun
size	size
tryst	tryst
conjur	conjuring
anger	anger
steadili	steadily
definit	definite
forfeit	forfeit
amroth	amroth
imit	imitations
result	result
geographi	geography
defil	defiled
wolv	wolves
abus	abuse
explor	explore
womb	wombs
explos	explosions
boromir	boromir
fri	fried
fief	fiefs
dumb	dumb
lust	lust
huorn	huorns
reserv	reserve
obscen	obscene
rill	rill
stagnant	stagnant
explod	exploded
clip	clip
galen	galen
dull	dull
lush	lush
shyli	shyly
pinion	pinion
nest	nest
128d	128d
menel	menel
stronghold	strongholds
fro	fro
squad	squad
yoke	yoke
wolf	wolf
wold	wolds
grain	grain
lurk	lurking
harvest	harvest
untouch	untouched
unheard	unheard
flash	flashed
flask	flask
fox	fox
orc-shield	orc-shield
for	for
declaim	declaim
trover	trover
tremend	tremendous
file	file
heathen	heathen
heather	heather
vie	vie
greediest	greediest
elenion	elenion
clove	clove
grasp	grasped
glad	glad
unloos	unloose
underf	underfed
evid	evidently
underg	undergate
grass	grass
gothmog	gothmog
limlight	limlight
dreari	dreary
provid	providing
fiercest	fiercest
unders	undersized
hunger	hunger
indispos	indisposed
vomit	vomited
guilti	guilty
angri	angry
provis	provisions
flare	flared
evil	evil
wove	wove
lugb	lugb
correspond	correspondence
discomfitur	discomfiture
heavili	heavily
grate	gratefully
cloth	cloth
changeabl	changeable
pockets	pocketses
downheart	downhearted
ve-ri	ve-ry
unlook	unlooked
1cb2	1cb2
stolen	stolen
balanc	balanced
deserv	deserves
farmstead	farmsteads
desert	deserted
wielder	wielder
mrs.	mrs.
indomit	indomitable
establish	established
postur	posture
lebennin	lebennin
quest	quest
visitor	visitors
welcom	welcome
fog	fog
victor	victor
foe	foes
cloud	clouds
thereaft	thereafter
wander	wandered
lump	lump
quell	quelling
shortest	shortest
grant	grant
safest	safest
intellig	intelligence
imbl	imbl
kinsman	kinsman
novembr	novembre
turret	turrets
imloth	imloth
catapult	catapults
buckland	buckland
grand	grand
grang	grange
alcov	alcoves
earthi	earthy
wose	woses
three	three
duck	duck
work	work
serri	serried
silli	silly
flank	flanks
worm	wormed
fli	fly
dialect	dialect
worn	worn
letter	letters
lull	lulled
wors	worse
imag	images
elentbri	elentbri
landmark	landmark
mazarbul	mazarbul
threw	threw
coney	coneys
even	even
word	words
wore	wore
destruct	destruction
brush	brush
kibil	kibil
ever	ever
clay	clay
ride	ride
yesteryear	yesteryear
ridg	ridge
wintri	wintry
goldberri	goldberry
fir	fir
flame	flames
gentl	gently
brute	brute
fit	fitted
uptak	uptake
scabbard	scabbard
fix	fixed
astray	astray
fini	finis
riddanc	riddance
dweller	dwellers
woul	woul
yore	yore
fine	fine
passion	passion
find	finding
vow	vow
cherri	cherry
profit	profit
safeti	safety
rick	rick
rich	rich
fill	filling
pronounc	pronouncement
squib	squib
clad	clad
outer	outer
clap	clapping
claw	claws
smote	smote
hors	horse
hiruva	hiruva
blister	blistered
suitabl	suitable
creatur	creature
fidget	fidgeting
therebi	thereby
horn	horn
upbourn	upbourn
float	floated
hose	hose
time	time
becom	become
folli	folly
hilltop	hilltops
budgeford	budgeford
quaver	quavering
niggard	niggard
recogn	recognized
quot	quote
rhyn	rhyn
quickbeam	quickbeam
thunder	thunder
host	hosts
buttress	buttresses
mansion	mansions
notion	notion
abreast	abreast
nedain	nedain
alway	always
tini	tiny
worship	worshipful
prentic	prentice
extract	extracts
assembl	assembled
pocket	pocket
unclo	unclos
bite	biting
mallo	mallos
herself	herself
overjoy	overjoyed
onlook	onlookers
lightheart	lighthearted
linen	linen
queer	queer
queen	queenly
passag	passage
subtleti	subtleties
prospect	prospect
cloven	cloven
ver	vers
unstain	unstained
trickeri	trickery
chiefli	chiefly
whither	whither
recoil	recoiled
westfold	westfold
hornlik	hornlike
tilt	tilt
hous	house
hour	hours
mimick	mimicking
till	till
ljofa	ljofa
bird	bird
immeasur	immeasurably
unwi	unwis
rootless	rootless
sidelong	sidelong
explan	explanation
greed	greed
cirion	cirion
rustic	rustic
cock	cocking
malic	malice
rauro	rauros
Wednesday	Wednesday
hood	hood
hoof	hoofs
dad	dad
hook	hook
vital	vital
dab	dab
nowher	nowhere
hoom	hoom
hoop	hoops
dai	dais
hoov	hooves
irensaga	irensaga
hoot	hooted
dan	dan
coomb	coomb
dam	dammed
day	day
prefer	prefer
firelight	firelight
footfal	footfalls
flagston	flagstone
hope	hopes
crunch	crunch
van	van
bill	bill
byre	byre
powder	powdered
blaze	blaze
flock	flocks
author	authority
blight	blight
shepherd	shepherds
gallant	gallant
uncommon	uncommon
lightn	lightning
doorwarden	doorwardens
coal	coals
overmatch	overmatched
uncea	unceas
coar	coars
nuzzl	nuzzled
coat	coat
calendar	calendar
hauberk	hauberk
acorn	acorn
wider	wider
great	great
widen	widening
nazgyl	nazgyl
knighthood	knighthood
improv	improve
bind	bind
meager	meager
cup	cup
stealthili	stealthily
hithoel	hithoel
cun	cunning
muzgash	muzgash
reason	reasons
perish	perished
observ	observed
given	given
aldaron	aldaron
sixti	sixty
sixth	sixth
poetri	poetry
memento	mementoes
refresh	refreshed
ruefulli	ruefully
crippl	crippled
succour	succoured
doughti	doughty
hola	hola
unceas	unceasingly
respons	responsible
undead	undead
hold	holding
homeward	homeward
tissu	tissue
ought	ought
hazel	hazels
foresight	foresight
home	home
telperion	telperion
bigger	bigger
pella	pella
moonris	moonrise
quit	quite
thank	thank
calmer	calmer
man-food	man-food
holm	holm
larch	larches
unne	unneed
holi	holy
methedra	methedras
thane	thane
hole	holes
portion	portion
manuscript	manuscript
tith	tithe
dozen	dozen
titl	title
green	green
hobbitri	hobbitry
giddi	giddy
greet	greet
frequent	frequent
gainsay	gainsaying
unwith	unwithered
fattest	fattest
besom	besom
hollow	hollows
norther	northerly
pupil	pupil
subsid	subsided
cur	curs
method	method
cut	cut
hostil	hostile
sunlit	sunlit
outcri	outcry
injur	injured
extraordinari	extraordinary
midyear	midyear
embroil	embroiled
survivor	survivors
snap	snapped
nostari	nostari
unwink	unwinking
unti	untied
honest	honestly
counterfeit	counterfeits
embroid	embroidered
reassur	reassuring
greensward	greensward
unto	unto
wildfir	wildfire
request	request
unsaf	unsafe
miller	miller
hobbiton	hobbiton
submerg	submerged
assist	assisting
clemati	clematis
hunch	hunched
tire	tired
likewis	likewise
unus	unused
winter	winters
panic	panic
tiro	tiro
forsooth	forsooth
flood	flood
unsay	unsay
hollin	hollin
airless	airless
offspr	offspring
eeri	eerie
defeat	defeats
hundr	hundred
entrap	entrapped
remnant	remnant
driftwood	driftwood
affray	affray
misinterpret	misinterpreting
thain	thain
falsehood	falsehood
folco	folco
giver	giver
townland	townlands
unse	unseeing
folca	folca
polit	polite
otherworld	otherworld
aflam	aflame
goodman	goodman
unsl	unsling
odditi	oddities
hairi	hairy
restiv	restive
loveli	loveliness
yellow	yellow
bruinen	bruinen
copi	copy
defens	defense
recruit	recruited
jetsam	jetsam
interest	interesting
beset	beset
battalion	battalions
fourteen	fourteen
primula	primula
cool	cool
cook	cook
cascad	cascade
briefer	briefer
June	June
waistcoat	waistcoat
varda	varda
unhe	unheed
conscious	conscious
swear	swear
argent	argent
blade	blade
vardo	vardo
conjuror	conjuror
packet	packet
lassemista	lassemista
sniff	sniff
sweat	sweated
weaponless	weaponless
deepest	deepest
ush	ush
decrea	decreas
drunk	drunk
foreseen	foreseen
use	useful
splayfing	splayfingered
gollum	gollum
difficult	difficult
cone	cones
barad	barad
driest	driest
palantnri	palantnri
uss	uss
krimpatul	krimpatul
landlord	landlord
shrunken	shrunken
missil	missiles
stagger	staggered
fireplac	fireplace
repres	represent
weaver	weavers
Juli	July
quay	quays
come	come
encumb	encumbered
comb	combed
forthcom	forthcoming
unabash	unabashed
unev	uneventful
erestor	erestor
hoarwel	hoarwell
defenc	defences
quak	quaking
defend	defenders
storehous	storehouse
screech	screeches
cow	cow
besid	beside
cot	cot
lidless	lidless
elven	elven
friendless	friendless
robin	robin
nevertheless	nevertheless
understood	understood
celandin	celandine
cosi	cosy
vessel	vessel
prudent	prudent
urg	urge
incant	incantation
cost	cost
sweep	sweeping
sweet	sweet
prudenc	prudence
obstacl	obstacle
hound	hound
glorfindel	glorfindel
baran	baran
restor	restoration
baraz	baraz
azanulbizar	azanulbizar
ventur	venture
upland	upland
thereon	thereon
snick	snicked
becam	became
veget	vegetables
corp	corps
corn	corn
hornblow	hornblowers
traitor	traitor
vittl	vittles
ravag	ravaged
mundburg	mundburg
good-by	good-bye
balrog	balrog
cri	cried
thunderstorm	thunderstorm
thus	thus
needless	needlessly
good-bi	good-by
lampwright	lampwrights
crater	crater
upo	upo
unit	united
thud	thudded
potato	potatoes
core	core
cord	cords
secreci	secrecy
assign	assigned
craggi	craggy
tier	tiered
cheerless	cheerless
shirefolk	shirefolk
modest	modest
aver	aver
avoid	avoid
burbrum	burbrum
bestir	bestirred
unab	unabated
mantelpiec	mantelpiece
nightl	nightl
southland	southlands
downward	downwards
sunshin	sunshine
trackless	trackless
blame	blame
therein	therein
unt	unt
platform	platform
uns	unse
cea	ceas
goat	goat
slender	slender
cushion	cushions
cistern	cisterns
inconveni	inconveniently
scrap	scraps
goal	goal
wndfara	wndfara
goad	goaded
dither	dithering
holman	holman
lifelong	lifelong
gibbet	gibbet
mirror	mirror
furrow	furrowed
gibber	gibbering
headway	headway
raven	raven
tidi	tidy
tide	tidings
nuncheon	nuncheon
lowland	lowlands
conveni	convenient
ornemalin	ornemalin
holbytlan	holbytlan
overheard	overheard
blank	blank
return	return
pavilion	pavilion
perian	perian
loyalti	loyalty
tick	tick
disgui	disguis
brockhous	brockhouses
hither	hither
1147	1147
undo	undoing
uin	uin
undu	undue
swell	swelling
cold	cold
unea	uneas
saturday	saturday
eyri	eyrie
uncl	uncle
howe	howe
howl	howl
chose	chose
elf-mag	elf-magic
renegad	renegade
barren	barren
convuls	convulsive
unkempt	unkempt
sandyman	sandyman
unrol	unrolling
wolvish	wolvish
undi	undying
barrel	barrel
ugh	ugh
blast	blast
ravin	ravine
highest	highest
protest	protested
convers	conversation
ugl	ugl
afterward	afterwards
affair	affair
choos	choosing
fimbrethil	fimbrethil
thorondor	thorondor
converg	converged
bolder	bolder
tunnelli	tunnelly
bestow	bestow
remors	remorsefully
canopi	canopy
septemb	septemb
coin	coining
briefli	briefly
eyot	eyot
downfallen	downfallen
adar	adar
kinsfolk	kinsfolk
felaruf	felaruf
adan	adan
messeng	messengers
adam	adamant
blare	blare
coil	coiling
gebir	gebir
sonor	sonorous
snowman	snowmane
sideway	sideways
lawk	lawks
berth	berth
lawn	lawn
ebb	ebb
ohtar	ohtar
bundushathyr	bundushathyr
shagrat	shagrat
until	until
untim	untimely
makin	makin
miruvureva	miruvureva
featureless	featureless
spearmen	spearmen
footman	footman
overmuch	overmuch
spider	spider
slow	slow
yesterev	yestereve
pyre	pyre
unmolest	unmolested
choke	choked
gaili	gaily
stench	stench
eag	eag
incompat	incompatible
valandil	valandil
overwhelm	overwhelmed
withstand	withstand
sevenfold	sevenfold
ear	earli
eas	ease
masonri	masonry
eav	eaves
guttur	guttural
eat	eat
hobnob	hobnobbing
fluffi	fluffy
berri	berries
peak	peak
sapphir	sapphire
spear-shaft	spear-shaft
wrist	wrists
sincahonda	sincahonda
wholesom	wholesome
peac	peace
write	write
clawfing	clawfingered
unveil	unveiled
confound	confounded
writh	writhed
cloudi	cloudy
laze	lazed
peat	peats
peal	peal
squint	squinting
hugest	hugest
doggrel	doggrel
bhosh	bhosh
darkest	darkest
abroad	abroad
shabbi	shabby
harrowd	harrowdal
adelard	adelard
would	would
esgaroth	esgaroth
slingston	slingstones
unclasp	unclasped
footmen	footmen
strider	strider
saucer	saucer
eel	eel
umbrella	umbrella
superb	superb
beryl	beryl
goatleaf	goatleaf
puddifoot	puddifoots
wring	wringing
bedroom	bedroom
slug	slugs
dread	dreadfully
straight	straight
edg	edge
pitfal	pitfalls
brooch	brooch
surpris	surprising
worrit	worriting
island	islands
sister	sister
sombr	sombre
swim	swimming
mostway	mostways
disappoint	disappointment
dissembl	dissemble
maker	maker
ahead	ahead
swung	swung
choic	choice
conspir	conspirator
crumbl	crumbling
elbow	elbow
mistak	mistake
stirrup	stirrups
sleepili	sleepily
street	streets
delici	delicious
dym	dym
peregrin	peregrin
dyr	dyr
barrier	barrier
bombadil	bombadil
supplant	supplant
mbryat	mbryat
pleasant	pleasant
chuckl	chuckled
limit	limit
flet	flet
westmansw	westmanswe
traceri	tracery
untam	untameable
flex	flexed
flew	flew
flee	flee
degre	degree
fled	fled
lofti	lofty
packag	packages
numb	numb
breezi	breezy
eleven	eleven
swift-fal	swift-falling
loftier	loftier
wound	wound
across	across
vultur	vultures
damper	damper
coppic	coppices
cobweb	cobwebs
wilder	wilderness
crafti	crafty
hastili	hastily
withdraw	withdraw
unbar	unbarred
banner	banners
vagabond	vagabonds
parlor	parlor
unwelcom	unwelcome
clawlik	clawlike
fulli	fully
larn	larn
firefoot	firefoot
honeycomb	honeycomb
shinbon	shinbone
lark	larks
gondor	gondor
rattl	rattling
larg	large
foretel	foretell
highroad	highroad
thereupon	thereupon
dangl	dangling
dismiss	dismiss
shieldmaiden	shieldmaiden
womanhood	womanhood
aton	atone
prowess	prowess
last	last
atop	atop
lass	lass
terror	terror
carpet	carpeted
premonit	premonition
lbthspell	lbthspell
fever	fever
humbl	humble
rasher	rashers
beleriand	beleriand
peck	peck
lash	lashed
pavement	pavement
wildgoo	wildgoos
flaw	flaw
flax	flax
impati	impatiently
flat	flat
ngaurhoth	ngaurhoth
unconsum	unconsuming
flap	flapping
unbent	unbent
surpri	surpris
flag	flags
thither	thither
tum	tum
bewild	bewildered
late	late
tub	tubs
eastern	eastern
easterl	easterlings
Sunday	Sunday
tug	tug
tress	tresses
highway	highway
copper	copper
chooser	chooser
souther	southerly
father	father
withdrew	withdrew
hillsid	hillsides
hooray	hooray
beauti	beauty
peel	peel
fright	frightfully
impass	impassable
peer	peered
peep	peeped
flourdumpl	flourdumpling
shadowless	shadowless
unburi	unburied
tributari	tributary
human	human
otho	otho
re-forg	re-forged
two	two
lave	laved
paveyard	paveyard
wednesday	wednesday
squirm	squirming
featur	features
nadan	nadan
anyth	anything
slag	slag
trapess	trapessing
don	don
dol	dol
chattel	chattels
slab	slab
shadowfax	shadowfax
elladan	elladan
chatter	chatter
dot	dots
gutter	gutters
neigh	neighing
humor	humor
beren	beren
hummock	hummock
fathom	fathoms
bight	bight
eastemnet	eastemnet
tri	trying
content	content
twentieth	twentieth
floor	floors
advi	advis
trothplight	trothplighted
daur	daur
shrewd	shrewd
hock	hocks
eressla	eressla
pert	pert
date	date
spring	spring
1070	1070
muffl	muffled
hollen	hollen
risen	risen
widow	widow
older	older
evenstar	evenstar
payment	payment
inventori	inventory
unsur	unsure
slay	slaying
spiral	spiral
irksom	irksome
bamfurlong	bamfurlong
galena	galenas
slap	slapping
dash	dashed
lain	lain
nonsense-word	nonsense-words
pattern	pattern
gelin	gelin
lair	lair
whithersoev	whithersoever
laid	laid
doe	does
dog	dogs
respect	respectable
slam	slammed
crumpl	crumples
moonset	moonset
whitwel	whitwell
attend	attend
stormcrow	stormcrow
uncheck	unchecked
natur	natural
pelt	pelts
ernil	ernil
dart	darts
hoar	hoars
daro	daro
darn	darn
dark	dark
darl	darling
aromat	aromatic
expand	expanded
withywindl	withywindle
swallow	swallowed
unarm	unarmed
happili	happily
dare	dared
northmen	northmen
shipwright	shipwright
northland	northlands
width	width
forebod	foreboding
expans	expanse
lake	lake
nurs	nurse
dun	dun
dum	dum
stonecrop	stonecrops
attent	attentive
due	due
dug	dug
additi	additi
toe	toes
sudden	suddenly
stratagem	stratagems
land	land
lanc	lances
hildinyar	hildinyar
pent	pent
lane	lane
destroy	destroyed
anywh	anywher
dri	dried
lank	lank
thistlewool	thistlewool
toy	toys
rocki	rocky
tom	tom
bedew	bedewed
tearless	tearless
immedi	immediately
eyesight	eyesight
tol	tol
tor	tor
penc	pence
too	too
top	top
strangl	strangled
runda	runda
lame	lame
daybreak	daybreak
terrif	terrific
snatch	snatches
ointment	ointment
flour	floured
lamp	lamp
slew	slew
chariot	chariots
certain	certainly
flout	flout
trickster	trickster
shift	shifting
tie	tied
danc	dancing
strewn	strewn
shine	shining
langstrand	langstrand
templ	temple
tis	tis
tin	tin
insect	insect
tim	tim
tip	tipped
shini	shiny
dank	dank
aearon	aearon
anduin	anduin
center	center
slim	slim
damp	damp
behold	behold
cirith	cirith
purcha	purchas
purpos	purposes
slid	slid
fillet	fillet
dame	dame
exil	exile
alert	alert
awkward	awkwardly
damn	damned
recognit	recognition
did	did
flown	flown
gnat	gnats
gnaw	gnawed
ascent	ascent
unbear	unbearable
booth	booth
exit	exits
booti	booty
tempt	tempting
record	records
obtain	obtained
anyhow	anyhow
ascend	ascend
woodwind	woodwind
cross	crossing
might	might
dew	dew
dale	dale
contest	contest
gentler	gentler
mister	mister
shire-hobbit	shire-hobbits
unsheath	unsheathed
del	del
hithlain	hithlain
campaign	campaigner
den	dens
spray	spray
perhap	perhaps
speaker	speaker
appetit	appetite
struggl	struggle
repaid	repaid
mourner	mourners
slip	slipped
nhere	nhere
slit	slit
aear	aear
olurin	olurin
spirit	spirits
ten	ten
lade	lade
ladl	ladle
bier	bier
tea	tea
ladi	lady
ceorl	ceorl
ted	ted
shire	shire
amidmost	amidmost
fragrant	fragrant
butteri	butteries
luggag	luggage
trebl	treble
iarwain	iarwain
repair	repair
parley	parley
adrift	adrift
ethir	ethir
elrohir	elrohir
shirt	shirt
durbatulyk	durbatulyk
lace	lace
fragranc	fragrance
earthward	earthwards
eyebrow	eyebrows
balconi	balcony
lack	lack
unaid	unaided
tread	tread
himself	himself
market	market
anyon	anyone
await	awaited
dwimmerlaik	dwimmerlaik
bide	bide
spoilt	spoilt
scrabbl	scrabbling
treat	treat
other	other
crown	crowned
sloe	sloe
expo	expos
hatchet	hatchet
syllabl	syllables
winyard	winyards
dim	dim
din	din
dip	dipping
order	orders
scuffl	scuffling
withi	withy
waysid	wayside
unalt	unaltered
die	die
slop	slopped
dig	dig
sandi	sandy
slot	slot
crowd	crowd
witho	witho
terrac	terraces
nostril	nostrils
swag	swag
dillo	dillo
provinc	province
origin	origins
capabl	capable
uncurl	uncurled
the	the
nativ	natives
thi	thy
begrudg	begrudged
settl	settle
sway	swayed
riski	risky
tha	tha
beaver	beaver
swam	swam
swan	swan
summer	summer
cluster	clustered
hnsil	hnsil
swap	swaps
hedg	hedge
keyston	keystone
coron	coronal
rushlight	rushlight
bivouack	bivouacked
lamedon	lamedon
ribbon	ribbon
joke	joke
heed	heed
gayer	gayer
grond	grond
evermor	evermore
timber	timber
skyless	skyless
innkeep	innkeeper
pierc	pierced
heel	heels
told	told
bolger	bolgers
somebodi	somebody
qualiti	quality
dissuad	dissuaded
toppl	toppling
toll	tolls
fealti	fealty
hirgon	hirgon
scrape	scraped
ephel	ephel
forbid	forbid
oblivi	oblivious
tomb	tomb
truce	truce
truck	truck
proffer	proffered
willow	willows
horni	horny
guard	guard
west-door	west-door
grew	grew
grey	greys
muster	mustered
sauro	sauro
scatha	scatha
deputi	deputy
trudg	trudged
tone	tones
tong	tongs
grope	groping
suffer	suffered
join	join
intric	intricate
labor	laboring
piti	pity
red	red
legend	legend
influenc	influence
goodbodi	goodbodies
discour	discours
groom	grooms
toom	toom
tool	tool
nightmar	nightmare
took	took
halloo	halloo
uncov	uncovered
afar	afar
guthlbf	guthlbf
dike	dike
arnen	arnen
motion	motion
heir	heir
sensibl	sensible
jool	jools
truer	truer
mistress	mistress
stutter	stuttering
hallow	hallow
speech	speech
ringlord	ringlord
well-pleas	well-pleased
unexplain	unexplained
countri	country
raw	raw
staddl	staddle
grab	grabbed
sandhil	sandhills
ray	rayed
connect	connected
jolt	jolts
rap	rap
varmint	varmint
treasuri	treasuries
disturb	disturber
rat	rat
discord	discord
steeper	steeper
fathomless	fathomless
knelt	knelt
footpad	footpad
supplement	supplement
lament	lament
derri	derry
hinder	hindered
merrymak	merrymaking
gram	gram
knell	knell
daffadowndilli	daffadowndilly
axin	axin
peasant	peasants
diver	divers
cellar	cellars
shapeless	shapeless
manag	managed
peach	peaching
dunlend	dunlendings
gray	gray
torn	torn
ding	ding
rai	rais
dine	dine
rah	rah
rag	ragged
ran	ran
ram	ram
fanci	fancied
tore	tore
measur	measure
peculiar	peculiar
mincemeat	mincemeat
lower	lower
poplar	poplars
scrawl	scrawl
concours	concourse
tobi	toby
dagger	dagger
wafer	wafer
help	helped
boner	boner
dint	dint
ingold	ingold
caradhra	caradhras
deadlier	deadlier
unafraid	unafraid
breathless	breathlessness
henc	hence
support	supporting
rot	rotting
rom	rom
forbad	forbade
health	health
row	row
dawdl	dawdle
rob	robbed
rod	rod
horsebreed	horsebreeders
dior	dior
branch	branches
tangl	tangled
upon	upon
flabbi	flabby
turmoil	turmoil
express	expression
villain	villain
speedi	speedy
dunharrow	dunharrow
easili	easily
endless	endless
craftsmen	craftsmen
brandi	brandy
grassless	grassless
drowsi	drowsiness
held	held
testi	testy
penalti	penalty
cattl	cattle
hell	hell
divid	divided
helm	helms
weskit	weskit
dire	dire
premis	premises
swifter	swifter
dirg	dirge
divin	divining
wildgoos	wildgoose
offic	office
ambar	ambar
strengthen	strengthen
truli	truly
dish	dishes
freez	freeze
hullo	hullo
suffic	suffices
forsak	forsake
snotti	snotty
tookland	tookland
parapet	parapet
disa	disa
freer	freer
mnri	mnri
drownd	drownded
disc	disc
shave	shave
necromanc	necromancer
impuls	impulse
aimless	aimlessly
defianc	defiance
younger	younger
joint	joints
hero	hero
easier	easier
defiant	defiant
descript	description
here	here
errantri	errantry
finger	fingers
daymeal	daymeal
groan	groan
mallorn-tre	mallorn-trees
trunk	trunks
herb	herbs
herd	herds
hamfast	hamfast
baggins	bagginses
nameless	nameless
decay	decayed
polish	polish
hardier	hardier
coral	corals
uncut	uncut
barliman	barliman
grit	grit
grip	gripped
grin	grins
grim	grim
sight	sight
carcas	carcases
toil	toiled
develop	developing
brigand	brigands
lowli	lowly
hearten	heartening
dive	diving
slacken	slackened
offer	offering
regrett	regrettable
ril	ril
rin	rin
offen	offens
rim	rim
steepli	steeply
rid	rid
naked	nakedness
furtiv	furtive
understand	understand
maintain	maintained
thirti	thirty
cloud-wrack	cloud-wrack
flow	flowed
lick	licked
holdwin	holdwine
impud	impudence
pier	pier
ungentl	ungentle
despoil	despoiled
glimp	glimps
underneath	underneath
nought	nought
impul	impuls
laugh	laughed
under	under
savag	savage
worms	wormses
undet	undeterred
piec	piece
argonath	argonath
glint	glinted
system	system
yonder	yonder
saddl	saddle
undef	undefeated
cnrdan	cnrdan
patrol	patrol
rug	rugged
rue	rue
eleni	eleni
lien	lien
armor	armor
run	run
elven-strand	elven-strands
life	life
truth	truth
rut	rutted
worker	worker
pick	picking
thjoden	thjoden
trust	trusted
kinder	kinder
truss	trussed
halbarad	halbarad
thirst	thirst
errandless	errandless
headmen	headmen
lieg	liege
remain	remained
woodmen	woodmen
insult	insult
historian	historians
world	world
echor	echor
waggon	waggon
myrtl	myrtles
valuabl	valuable
goest	goest
tumladen	tumladen
earli	early
proclaim	proclaim
grandson	grandson
demand	demand
morthond	morthond
upri	upris
star-glass	star-glass
rub	rubbed
daeron	daeron
teacher	teacher
unaccount	unaccountably
femal	female
attempt	attempt
gallop	galloping
liar	liar
opposit	opposite
unfurl	unfurled
merci	mercy
firmer	firmer
chip	chip
dnnen	dnnen
counten	countenance
chin	chin
counter	counter
departur	departure
reign	reigns
sever	several
junip	junipers
flui	flui
alarm	alarmed
hasufel	hasufel
seven	seven
headman	headman
disdain	disdained
perman	permanently
birth	birth
lili	lily
sad	sadness
breastwork	breastwork
meddl	meddle
sag	sag
lyin	lyin
sai	sai
feather	feather
inquisit	inquisitive
inmost	inmost
unguess	unguessed
sam	sam
masster	masster
shimmer	shimmering
blanch	blanch
reforg	reforged
stock	stock
pint	pint
avbnier	avbnier
impli	imply
slept	slept
gbrulf	gbrulf
whirlwind	whirlwind
pine	pine
ping	ping
grove	groves
topic	topic
like	like
sap	sap
sau	sau
grown	grown
sat	sat
growl	growled
sar	sar
growi	growi
say	say
saw	saw
toss	tossing
yearn	yearned
ruddi	ruddy
bilberri	bilberry
flit	flitting
link	link
line	line
ling	ling
therefor	therefore
glower	glowering
jore	jored
lind	lind
galadriel	galadriel
sorrowi	sorrowi
pile	piled
limp	limp
fighter	fighters
kitten	kitten
robust	robust
aforetim	aforetime
corner	corner
morgai	morgai
encroach	encroached
lime	limes
limb	limbs
gracious	gracious
broken	broken
heirloom	heirlooms
jothain	jothain
lilt	lilting
beacon	beacons
omentielvo	omentielvo
despond	despondently
horror	horror
cornel	cornel
sparkl	sparkling
remark	remarkable
plight	plight
pungent	pungent
heat	heats
function	functions
anchor	anchored
heav	heaved
heap	heap
hear	hear
vengeanc	vengeance
toward	towards
heal	heal
head	heads
disobey	disobeyed
dwarv	dwarves
jowl	jowl
harrowdal	harrowdale
undim	undimmed
polici	policies
exclaim	exclaimed
oppress	oppressed
undid	undid
swollen	swollen
impenetr	impenetrable
soften	softened
dwarf	dwarf
whitfurrow	whitfurrows
softer	softer
lift	lifting
emerg	emerge
town	town
archway	archway
chop	chopping
trembl	trembling
choo	choos
gross	gross
ettend	ettendal
unsleep	unsleeping
healer	healers
fanuidhol	fanuidhol
pipe	pipe
vapor	vapor
deform	deformity
easiest	easiest
chimney	chimney
grandsir	grandsires
corps	corpses
sixteen	sixteen
reappear	reappear
awok	awoke
deject	dejectedly
laund	launds
noisi	noisy
teach	teach
elsewhith	elsewhither
impot	impotent
richer	richer
savor	savored
enhanc	enhanced
group	group
palfrey	palfrey
freedom	freedom
sha	sha
horn-cal	horn-call
viel	viel
agin	agin
decept	deceptive
agil	agility
pine-tr	pine-tre
irresolut	irresolute
agit	agitation
dry-foot	dry-footed
she	she
effici	efficient
naith	naith
shi	shi
intact	intact
dimril	dimrill
herdsmen	herdsmen
death	death
folcwin	folcwine
batter	battering
isengard	isengard
woolli	woolly
stealth	stealth
magnifi	magnified
view	view
explain	explaining
meddler	meddlers
decent	decent
grnma	grnma
wizard	wizard
bregalad	bregalad
downfal	downfall
six	six
innard	innards
pivot	pivoted
transpar	transparency
weaker	weaker
lasto	lasto
weaken	weakening
seeth	seething
perch	perched
undul	undulating
intertwin	intertwined
histori	history
racket	racket
compliment	compliment
soundless	soundlessly
unwav	unwavering
sit	sit
pallid	pallid
sir	sir
sip	sip
deeper	deeper
endeavor	endeavored
sunset	sunset
sin	sin
deepen	deepened
engag	engaged
warrant	warrant
michel	michel
snivel	snivelling
stupid	stupid
bridgefield	bridgefields
grassi	grassy
gratitud	gratitude
everybodi	everybody
impromptu	impromptu
brisk	brisk
lndeed	lndeed
undon	undone
light	light
tinbon	tinbone
thinbon	thinbone
decemb	decemb
nassti	nassty
illumin	illuminated
oneself	oneself
nargothrond	nargothrond
lassi	lassi
bastard	bastards
tooth	tooth
scowl	scowl
immort	immortal
pebbl	pebbles
sprawl	sprawling
vice	vice
set	set
shrill	shrill
perplex	perplexities
herubrand	herubrand
rubi	ruby
daddi	daddy
mathom	mathoms
bloodthirsti	bloodthirsty
swift-mov	swift-moving
mirag	mirage
outlier	outlier
slaughter	slaughter
hereabout	hereabouts
unsaid	unsaid
sea	sea
weatherstain	weatherstained
deceit	deceit
aggriev	aggrieved
diminish	diminished
deceiv	deceived
see	see
sec	sec
merri	merry
trammel	trammel
recollect	recollect
sen	sens
outlaw	outlaw
doubtless	doubtless
scorn	scornful
collap	collaps
yield	yield
ancalima	ancalima
concern	concerning
collar	collar
glide	gliding
score	scored
peril	perilous
persist	persisted
council	council
chew	chewing
spe	spe
multitudin	multitudinous
brambl	brambles
winch	winch
spi	spies
buyer	buyer
entmaiden	entmaidens
worth	worth
chee	chees
pinnath	pinnath
twelfth	twelfth
vine	vines
ringwraith	ringwraiths
remov	removed
avail	avail
son	son
underfoot	underfoot
tatter	tattered
perki	perky
windi	windy
sworn	sworn
sob	sobs
kindli	kindliness
subject	subject
hammer	hammer
highland	highlands
vanwa	vanwa
retent	retentive
viol	viols
counsel	counsel
scour	scour
birch	birches
scout	scouts
minist	minister
eldar	eldar
valimar	valimar
garrison	garrisoned
hunter	hunters
communic	communicative
unhors	unhorsed
terrifi	terrified
fearless	fearless
20th	20th
tobacco	tobacco
design	designs
chan	chan
sli	sly
char	charred
permit	permitted
chap	chap
woodman	woodman
firebrand	firebrand
chat	chat
gangway	gangways
wager	wager
reck	recking
sky	sky
level	level
deepli	deeply
rece	reced
ski	ski
poverti	poverty
imperish	imperishable
overlap	overlapped
outburst	outburst
cheeri	cheery
astir	astir
circumst	circumstances
splutter	spluttering
merciless	merciless
mother	mother
standstil	standstill
mattress	mattresses
debat	debated
rede	rede
seri	series
terribl	terrible
swanfleet	swanfleet
worri	worried
bellow	bellow
amiss	amiss
ream	reams
real	real
passeng	passenger
monolith	monoliths
scoop	scoop
read	read
unintent	unintentional
serv	serve
platter	platters
coach	coach
worst	worst
rear	rear
shriek	shrieking
taught	taught
vile	vile
reap	reap
celebdil	celebdil
merit	merit
away	away
sprang	sprang
awar	aware
wrong	wrong
noisom	noisome
awak	awake
bagshot	bagshot
compound	compounded
conceiv	conceived
wroth	wroth
rung	rung
wrote	wrote
abomin	abominable
ignobl	ignoble
desir	desire
rune	runes
thistl	thistles
whinni	whinnying
nanduhirion	nanduhirion
scheme	schemes
carach	carach
clang	clanged
happen	happened
thornless	thornless
ghyll	ghylls
monster	monsters
meadow-flow	meadow-flowers
manwi	manwis
profess	profession
slobber	slobbering
-rrb-	-rrb-
dunno	dunno
wive	wives
fellow	fellow
arnor	arnor
mirki	mirky
lucki	lucky
roost	roosting
rhyme	rhyme
irrespon	irrespons
common	commonly
daughter	daughters
thengl	thengling
syl	syl
brushwood	brushwood
nohow	nohow
commod	commodity
laden	laden
lhaw	lhaw
document	documents
punctual	punctual
grub	grub
bliss	blissful
commot	commotion
seedl	seedling
direct	directed
reed	reeds
assur	assured
later	later
reek	reek
underhil	underhill
reel	reeled
puzzl	puzzle
loiter	loitering
fingla	finglas
grrr	grrr
briar	briars
grabbl	grabbling
ssh	ssh
abrupt	abrupt
reli	relied
after	after
sss	sss
commit	committed
eastland	eastlands
tight-curl	tight-curled
varieti	variety
unclench	unclenching
taper	tapering
bribe	bribing
fruit	fruit
latch	latch
sta	sta
household	household
alfirin	alfirin
horizon	horizon
uneas	unease
swoop	swooped
cross-road	cross-roads
sti	sties
swoon	swooned
pearl	pearl
thorn-bush	thorn-bushes
khele	kheled
sue	sue
brick	brick
about	about
black-leath	black-leather
shadowmer	shadowmere
sup	sup
sun	sun
elder	elder
disgust	disgust
sur	surly
carchost	carchost
companion	companions
circlet	circlet
mountain-slop	mountain-slopes
raker	rakers
clutch	clutching
hallo	hallo
bridg	bridge
rebuild	rebuilding
bride	bride
agelong	agelong
rust	rust
mantl	mantle
rein	reined
rush	rushing
bridl	bridle
rebuilt	rebuilt
vambrac	vambrace
punish	punishment
altogeth	altogether
crickhollow	crickhollow
scrambl	scrambling
grot	grots
blink	blinked
grow	grow
claim	claim
swore	swore
firstborn	firstborn
blind	blindly
brief	brief
recoveri	recovery
sword	sword
incomplet	incomplete
unconquer	unconquerable
tag	tag
pinnacl	pinnacle
halfl	halfling
tad	tads
bring	bring
kinship	kinship
corrupt	corrupts
conceal	concealed
brink	brink
repr	repres
farmer	farmer
horseman	horseman
homecom	homecoming
marigold	marigold
weather	weathered
hiruvalyl	hiruvalyl
unnatur	unnatural
warili	warily
wine	wine
coars	coarse
wind	wind
rude	rude
wing	wings
wink	wink
prevent	prevent
relaps	relapsed
hillmen	hillmen
porter	porter
despi	despis
hoofbeat	hoofbeats
soldier	soldiers
tax	tax
shrink	shrink
tar	tar
drizzl	drizzle
tap	tapping
afor	afore
clawf	clawfing
kneel	kneeling
unwit	unwitting
doorway	doorway
unwis	unwise
engin	engines
rend	rending
sunri	sunris
unwil	unwilling
drowsili	drowsily
probe	probe
mirth	mirth
mugwort	mugworts
rent	rent
luckili	luckily
fairspoken	fairspoken
gurgl	gurgling
rema	rema
wipe	wiping
astonish	astonishment
overwritten	overwritten
oili	oily
barrow	barrows
summit	summit
seeker	seekers
bleari	bleary
wish	wish
wise	wise
ruin	ruin
renew	renewed
wisp	wisp
caveyard	caveyard
surmount	surmounted
anyway	anyway
wist	wistfully
primerol	primeroles
colourless	colourless
halfway	halfway
horsemen	horsemen
tamarisk	tamarisk
heraldri	heraldry
caress	caressed
murder	murder
uppish	uppish
clasp	clasped
wire	wire
-LRB-	-LRB-
portag	portage
northern	northern
ambassador	ambassador
window	window
unravel	unravelling
summon	summoned
rebellion	rebellion
rest	resting
nallon	nallon
clash	clash
disguis	disguised
talkat	talkative
duilin	duilin
desol	desolation
sunni	sunny
yjni	yjni
coast	coasts
crescent	crescent
maladi	malady
ceremoni	ceremony
stairway	stairway
voyag	voyage
timeless	timeless
rule	rules
leaper	leaper
baker	bakers
dealt	dealt
with	with
entri	entry
assent	assented
leastway	leastways
golden-r	golden-red
rubbish	rubbish
afir	afire
elsewh	elsewher
marrow	marrow
treegarth	treegarth
manhood	manhood
close-furl	close-furled
twill	twill
hesit	hesitated
ahea	ahea
lobelia	lobelia
wayward	wayward
flutter	fluttering
judgement	judgement
nake	naked
accid	accident
enthron	enthroned
edgewi	edgewis
conquer	conquered
resolv	resolved
transluc	translucent
patter	patter
fairest	fairest
overcast	overcast
bit	bit
shorten	shorten
unquiet	unquiet
foil	foiled
twine	twined
nephew	nephew
raindrop	raindrop
sick	sick
big	big
entir	entirely
shorter	shorter
nail	nails
drove	drove
nineti	ninety
hamlet	hamlet
verili	verily
splinter	splinter
invert	inverted
aghast	aghast
side	side
tussocki	tussocky
sackville-baggins	sackville-bagginses
tumult	tumult
asfaloth	asfaloth
cudgel	cudgel
elud	eluded
drows	drowse
trampl	trampling
pickl	pickle
falter	falter
drown	drowned
unhasti	unhasty
sneer	sneered
sieg	siege
grassclad	grassclad
ithilien	ithilien
bob	bobbing
steward	steward
hardihood	hardihood
horsetail	horsetail
bog	bogs
word-yet	word-yet
melancholi	melancholy
lazili	lazily
greenwood	greenwood
astound	astounding
esmeralda	esmeralda
elus	elusive
rustl	rustled
overthrow	overthrow
inevit	inevitably
salver	salver
rusti	rusty
yestermorn	yestermorn
morgoth	morgoth
clemenc	clemency
foref	forefing
crack	crack
misseth	misseth
sift	sift
lamplight	lamplight
utter	utter
elessar	elessar
sign	sign
nape	nape
gotten	gotten
forev	forever
overflow	overflow
distinguish	distinguish
fores	forese
sigh	sighing
entranc	entrance
cradl	cradles
remmirath	remmirath
gloomili	gloomily
cautious	cautiously
pat	patting
invent	inventing
name	name
paw	paw
enquantuva	enquantuva
pay	pay
whitish	whitish
linden	linden
mistrust	mistrust
flatteri	flattery
pad	pads
asphodel	asphodel
taller	taller
corslet	corslet
leech	leech
pah	pah
depend	depends
half-empti	half-empty
elyl	elyl
pan	pan
neither	neither
bom	bom
trowel	trowels
deep-cut	deep-cut
sureti	surety
twiggi	twiggy
box	box
bow	bowed
roheryn	roheryn
dagorlad	dagorlad
loath	loathing
sneak	sneaking
boy	boys
promi	promis
harbor	harbors
woodcrafti	woodcrafty
overhead	overhead
blend	blended
unrememb	unremembered
deedl	deedle
becaus	because
smile	smiling
raider	raiders
hornrock	hornrock
itself	itself
disastr	disastrous
final	finally
bag	bag
coloni	colony
career	careering
convinc	convince
bad	bad
hitherto	hitherto
prong	pronged
bay	bay
longshank	longshanks
bat	bats
bar	barred
foam	foamed
foal	foaled
roomti	roomty
unbroken	unbroken
unusu	unusual
proof	proofs
somewher	somewhere
plea	pleas
cruel	cruel
meara	mearas
foray	forayers
elrond	elrond
butt	butt
unprepar	unprepared
ilex	ilex
kept	kept
addit	additions
overhear	overhearing
propo	propos
pea	peas
strangest	strangest
handsom	handsome
beautiful	beautifuller
exceed	exceedingly
fanfar	fanfare
bestial	bestial
fouler	fouler
shuffl	shuffled
pen	pen
pitiless	pitiless
per	per
sunris	sunrise
twist	twisting
enthusiast	enthusiastic
unfad	unfading
tougher	tougher
pli	plied
glimmer	glimmer
floweri	flowery
neighbor	neighbor
swarthier	swarthier
shingl	shingle
moreov	moreover
buzz	buzzed
exact	exact
difficulti	difficulty
haysend	haysend
kindl	kindled
especial	especiall
kindn	kindn
beg	beg
clack	clack
bee	bee
bed	bed
kindr	kindred
finer	finer
miser	miserably
ber	ber
meant	meant
enter	entered
dew-drop	dew-drops
ben	ben
blest	blest
cormallen	cormallen
whole	whole
bless	bless
rimmon	rimmon
bet	bet
crumb	crumbs
greasi	greasy
surefoot	surefooted
appoint	appointed
quick	quick
rekindl	rekindle
enthral	enthralled
gwaihir	gwaihir
guardroom	guardroom
greedili	greedily
entrail	entrails
smallburrow	smallburrow
longwi	longwis
bid	bid
naur	naur
denial	denial
despair	despaired
uruk	uruks
domin	domination
applaud	applauding
fatter	fatter
talan	talan
play	played
finch	finch
adder	adders
glimps	glimpse
pig	pig
applaus	applause
plan	planned
pin	pins
pip	pip
salvag	salvage
calacirian	calacirian
crackl	crackle
proud	proud
pit	pit
evergreen	evergreen
baranduin	baranduin
glorious	glorious
dwelleth	dwelleth
pop	pops
orald	orald
pot	pots
poi	pois
royalti	royalty
oroml	oroml
wayworn	wayworn
brandir	brandir
provi	provis
prove	proved
whoop	whoop
Januari	January
pps	pps
sire	sires
nenya	nenya
quiet	quiet
unsettl	unsettled
badger	badgers
obey	obey
remor	remors
remot	remote
cataract	cataracts
crane	craning
fetter	fetters
overborn	overborne
kingship	kingship
sought	sought
bump	bump
beth	beth
useless	useless
chalcedoni	chalcedony
re-tak	re-take
palantnr	palantnr
best	best
gold	gold
complet	complete
celerdain	celerdain
unplea	unpleas
mordor	mordor
harlond	harlond
thorn	thorn
bull	bull
bulk	bulk
dumpl	dumpling
maggot	maggot
wreckag	wreckage
bulg	bulging
explo	explos
nightingal	nightingale
gave	gave
octob	october
prowl	prowls
postern	postern
rubbl	rubble
unload	unload
ruinat	ruination
remit	remitted
toeless	toeless
bend	bend
good	good
metal	metal
roadsid	roadside
gong	gongs
miscarri	miscarry
busi	business
closest	closest
bush	bush
gandal	gandal
sooner	sooner
absenc	absence
dislik	disliking
leather	leather
crash	crashing
arous	arouse
belief	belief
whose	whose
cavern	cavernous
behind	behind
wayfar	wayfarers
gone	gone
deafest	deafest
lurch	lurched
bell	bells
beli	belie
believ	believed
west-sid	west-side
emissari	emissaries
unfit	unfitting
buri	buried
belt	belt
burg	burg
burn	burning
irrespons	irresponsible
lotho	lotho
crust	crusts
truncheon	truncheon
cat	cats
can	can
crush	crushing
rearguard	rearguard
cap	cap
children	children
warlik	warlike
nimloth	nimloth
ornament	ornament
expos	exposed
filbert	filbert
starless	starless
striven	striven
thong	thongs
unhind	unhindered
esgalduin	esgalduin
orchard	orchard
interrupt	interrupted
pri	pried
couch	couch
unsulli	unsullied
gaze	gazed
somewhat	somewhat
unlabel	unlabelled
bent	bent
hbma	hbma
undumiel	undumiel
craft	craft
gors	gorse
outlin	outline
tussock	tussock
famissh	famisshed
quill	quill
beyond	beyond
unherald	unheralded
sustain	sustaining
tongu	tongues
brm	brm
likewi	likewis
surviv	surviving
curvi	curvi
ilyl	ilyl
unlock	unlock
gape	gape
untast	untasted
lumlanor	lumlanor
brr	brr
plough	plough
westemnet	westemnet
surfac	surface
gorg	gorge
gore	gore
westron	westron
broider	broidered
hobbl	hobbled
simmer	simmering
pur	purs
put	put
smoother	smoother
balin	balin
puf	puffed
bulwark	bulwark
unasham	unashamed
serpent	serpent
twice	twice
keenest	keenest
eaten	eaten
friendli	friendliness
undamag	undamaged
imprison	imprisonment
silk	silk
sill	sill
entangl	entangled
sunless	sunless
overthrew	overthrew
fifteenth	fifteenth
bur	bur
disrespect	disrespect
beforehand	beforehand
gang	gang
budg	budge
bud	buds
rbmar	rbmar
smial	smials
foremoth	foremother
crownless	crownless
but	but
waterless	waterless
outlet	outlet
buy	buy
tauremornaluml	tauremornaluml
shortag	shortage
vassal	vassals
been	been
beer	beer
accur	accurs
accus	accusing
survey	survey
longer	longer
gown	gown
stronger	stronger
beorn	beorn
sink	sink
gate	gate
sinc	since
charnel	charnel
sunlend	sunlending
sing	sing
stretch	stretched
outstretch	outstretched
greenleaf	greenleaf
pitch	pitch
shepherdless	shepherdless
fulfil	fulfilling
gash	gash
misti	misty
upper	upper
gasp	gasp
resort	resort
comprehend	comprehended
mallorn	mallorn
cramp	cramped
insati	insatiable
pheriannath	pheriannath
hyth	hythe
niphredil	niphredil
magnitud	magnitude
foremost	foremost
darksom	darksome
oxen	oxen
garb	garb
bye	bye
oathbreak	oathbreakers
preciouss	preciouss
agre	agree
garn	garn
unforeseen	unforeseen
stori	story
store	stored
mond	monds
rightabout	rightabouts
spouthol	spouthole
entertain	entertainments
eregion	eregion
storm	storm
weapontak	weapontake
instant	instant
saffron	saffron
wretch	wretched
mood	mood
nutiml	nutiml
furnitur	furniture
instanc	instance
nbli	nbli
aii	aii
ail	ailing
valor	valor
aim	aimed
butter	butter
citadel	citadel
retain	retained
air	air
unlighten	unlightened
bowstr	bowstring
undulbvl	undulbvl
tyrant	tyrant
torchlight	torchlight
unwholesom	unwholesome
shrub	shrubs
aid	aid
shrug	shrugged
burial	burial
guldur	guldur
repent	repent
faster	faster
respon	respons
consider	considerable
domain	domain
current	currents
carrion	carrion
sheen	sheen
sheep	sheep
left	left
comprehens	comprehension
tharkyn	tharkyn
sheer	sheer
fasten	fastened
lineag	lineage
sheet	sheet
stood	stood
bear	bearing
beat	beats
inclin	incline
unintellig	unintelligible
bean	beans
allegi	allegiance
stool	stool
stoop	stooping
mindolluin	mindolluin
exchang	exchanged
gain	gained
bead	bead
stoor	stoors
agh	agh
satisfi	satisfy
agr	agre
beak	beak
beam	beams
courtyard	courtyard
ago	ago
affin	affinity
shortcom	shortcomings
inaccess	inaccessible
dwell	dwells
stoni	stony
stone	stone
dwelt	dwelt
dabbl	dabbling
pitiabl	pitiable
flawless	flawless
greenfoot	greenfooted
uprai	uprais
orophin	orophin
autumn	autumn
ann	ann
overtaken	overtaken
gait	gait
chilli	chilly
ant	ants
radiant	radiant
leng	leng
ani	any
queerer	queerer
edrendil	edrendil
sleeper	sleepers
lent	lent
drain	drained
riddermark	riddermark
and	and
bemus	bemused
victori	victory
radianc	radiance
curio	curios
metta	metta
speck	specks
thrive	thrive
lend	lend
sleepyhead	sleepyhead
redress	redress
lonesom	lonesome
susten	sustenance
tellumar	tellumar
silver-net	silver-netted
norburi	norbury
gale	gale
pathless	pathless
numbskul	numbskulls
waist	waist
husband	husbanding
stole	stole
leaderless	leaderless
mirrorm	mirrormer
shire-reckon	shire-reckoning
all	all
marshland	marshland
gaml	gamling
long-endur	long-enduring
speed	speed
ale	ale
handi	handy
longfath	longfathers
ala	alas
game	game
gamg	gamge
handl	handle
cockl	cockle
shed	shed
reckon	reckon
genuin	genuine
secur	secure
raini	rainy
approach	approached
manner	manner
amend	amends
abe	abed
curdl	curdled
onset	onset
hubbub	hubbub
abl	able
mous	mouse
gimlet	gimlets
turret-door	turret-door
slime	slime
correct	correct
sheath	sheath
button	buttons
respit	respite
slimi	slimy
idiot	idiotic
portend	portends
move	moved
edora	edoras
gladder	gladder
fugit	fugitives
plink	plink
gladden	gladden
sentri	sentry
untru	untrue
threaten	threatening
sling	sling
mown	mown
slink	slinking
northmost	northmost
biter	biter
month	month
streamlet	streamlet
region	regions
moss	moss
most	most
necess	necessity
surround	surrounded
crave	crave
thrill	thrill
sharpen	sharpened
moth	moths
unslung	unslung
sharper	sharper
disquiet	disquieted
expan	expans
hoari	hoary
crawl	crawled
huntsmen	huntsmen
portent	portents
hoars	hoarse
doner	doner
maledict	malediction
twofold	twofold
experi	experience
ghvsh	ghvsh
hoard	hoarded
account	accounts
earth	earth
scholar	scholar
loremast	loremasters
outnumb	outnumbered
spelt	spelt
twofoot	twofoot
necessari	necessary
temper	tempers
more	more
unbeliev	unbelievable
moonlit	moonlit
age	age
morn	morning
pushdug	pushdug
carven	carven
spell	spell
lover	lover
slowcoach	slowcoach
unfought	unfought
sharpli	sharply
scream	scream
dumbl	dumbly
shelterless	shelterless
gabl	gable
levi	levies
occas	occasion
stout	stout
handcart	handcarts
moon	moon
crazi	crazy
moot	moot
firework	fireworks
moor	moors
add	add
evereven	evereven
infus	infusion
wherein	wherein
spent	spent
lest	lest
less	less
those	those
long-vanish	long-vanished
expel	expelled
expen	expens
proudfeet	proudfeet
ach	ache
devis	devise
tamer	tamer
enmiti	enmity
devil	devils
spend	spend
huntsman	huntsman
tighter	tighter
noldor	noldor
meadow	meadow
shear	shears
tighten	tightened
theori	theory
devic	devices
local	local
sheav	sheaves
act	acted
baggag	baggage
acr	acres
bench	benches
doriath	doriath
herdfolk	herdfolk
westward	westward
forlong	forlong
stonehous	stonehouse
nazg	nazg
journey	journey
fainter	fainter
nearbi	nearby
stripe	stripes
acquaint	acquaintance
tortuous	tortuous
grace	grace
peopl	people
slier	slier
ownership	ownership
gossam	gossamer
Septemb	September
staunch	staunch
toad	toad
harp	harps
graven	graven
thrice	thrice
harm	harm
hark	hark
graver	graver
decis	decision
plung	plunged
bygon	bygone
plunk	plunk
hart	harts
gravel	gravel
plot	plot
bergil	bergil
shrivel	shrivel
hare	hare
slide	sliding
firewood	firewood
hard	hard
axe	axe
calaciryo	calaciryo
dulli	dully
barricad	barricade
intrus	intrusion
settlement	settlement
smith	smiths
plume	plumed
smite	smite
burzum	burzum
loung	lounging
calacirya	calacirya
elbereth	elbereth
plop	plop
duinhir	duinhir
decid	decided
string	string
keen	keen
keel	keel
frighten	frightened
plod	plod
robber	robbers
keep	keeping
afford	afford
aye	aye
morning-light	morning-light
mighti	mighty
occa	occas
hall	hall
hale	hale
half	half
leprous	leprous
moonshin	moonshine
outright	outright
icicl	icicles
probabl	probably
combin	combined
nearer	nearer
nonsen	nonsens
lauril	lauril
fowl	fowl
shallow	shallow
preserv	preserved
inadvert	inadvertently
putrid	putrid
coldest	coldest
angmar	angmar
continu	continued
chetwood	chetwood
finish	finished
temptat	temptation
congratul	congratulate
homeless	homeless
killer	killer
rushey	rushey
expend	expended
interpret	interpret
firelit	firelit
baggin	baggins
signal	signals
repeat	repeated
hang	hanging
shun	shunned
hand	hands
silivren	silivren
shut	shut
springless	springless
swiftest	swiftest
four	four
foul	foul
panopli	panoply
drawn	drawn
includ	including
well-f	well-fed
accord	according
elen	elen
gaunt	gaunt
conspiraci	conspiracy
expens	expensive
indefinit	indefinitely
halt	halted
halv	halves
forth	forth
shell	shell
forti	forty
laurelindurenan	laurelindurenan
relax	relaxed
solitud	solitude
shelv	shelving
foss	fosse
pluck	plucking
expect	expected
dealer	dealer
circular	circular
are	are
sulli	sullied
arc	arc
relat	relatives
aro	aros
shelf	shelf
arm	arm
relap	relaps
ari	aris
presenc	presence
fork	forked
form	form
forn	forn
imagin	imagining
heartless	heartless
art	arts
forsa	forsa
displeasur	displeasure
lindir	lindir
lusti	lusty
fort	forts
plum	plum
hawk	hawks
skirmish	skirmish
present	present
harden	harden
ash	ashes
nicest	nicest
nowt	nowt
sturdi	sturdy
citi	city
ask	asked
harder	harder
picnic	picnic
shin	shin
haze	haze
malbeth	malbeth
ship	ship
neglect	neglected
henneth	henneth
stranger	strangers
hazi	hazy
delight	delighted
mode	mode
ape	ape
black-lik	black-like
money	money
practic	practiced
forg	forging
ford	ford
forc	force
mock	mocked
apt	apt
pyramid	pyramids
relea	releas
tentacl	tentacle
scatter	scattering
point	point
strive	strive
hillock	hillock
drabbl	drabbling
shaken	shaken
sundown	sundown
ungol	ungol
vigil	vigilance
shop	shop
falmalinnar	falmalinnar
hate	hate
hath	hath
foot	foot
forlorn	forlorn
vaster	vaster
show	show
smitten	smitten
shou	shou
fool	fool
shot	shot
verit	veritable
dismal	dismal
flotsam	flotsam
independ	independent
dismay	dismay
combat	combat
tintal	tintall
shod	shod
whatev	whatever
shoe	shoes
hatr	hatred
awe	awe
except	except
holbytla	holbytla
drape	draped
sunlight	sunlight
moan	moaning
vigor	vigor
hast	haste
mellyrn	mellyrn
companionship	companionship
guesthous	guesthouse
food	food
moat	moat
thingol	thingol
wrestl	wrestling
vorondil	vorondil
unexpect	unexpected
reject	rejection
have	have
ass	ass
fanuilo	fanuilos
fond	fond
fresh	fresh
dwimmer	dwimmer
niceti	nicety
ate	ate
maiden	maiden
rinen	rinen
ferthu	ferthu
ath	ath
folk	folk
doorward	doorwards
signif	signific
barahir	barahir
fold	fold
drank	drank
fertil	fertile
dazzl	dazzling
haul	hauled
occur	occurs
hive	hive
thrihyrn	thrihyrne
earthborn	earthborn
nois	noises
moisti	moisty
half-trol	half-trolls
furnish	furnished
knock	knocking
roll	rolling
bagronk	bagronk
pine-tre	pine-trees
hrum	hrum
movement	movements
angrili	angrily
quicksand	quicksand
right	right
bought	bought
eighti	eighty
eighth	eighth
inquiri	inquiries
rigid	rigid
partial	partial
baffl	baffle
touch	touched
distanc	distance
array	arrayed
gammer	gammers
snow-whit	snow-white
nen	nen
behavior	behavior
smelli	smelly
net	netted
mischanc	mischances
hiss	hiss
justifi	justify
broil	broil
sicken	sickening
mention	mention
tragic	tragic
nef	nef
lossarnach	lossarnach
fantasi	fantasy
fern-brak	fern-brake
hazard	hazard
excel	excellently
yess	yess
broke	broke
new	new
foulbelli	foulbellied
bivouac	bivouac
masterless	masterless
ensu	ensuing
edraith	edraith
appea	appeas
mover	mover
root	roots
udyn	udyn
unshadow	unshadowed
march	marched
height	height
rope	rope
nobler	nobler
twenty-f	twenty-five
excav	excavation
entrust	entrust
unfigur	unfigured
dement	demented
grassland	grassland
watch	watching
moisten	moisten
yesterday	yesterday
regiment	regiment
sluggish	sluggish
shiretalk	shiretalk
ajar	ajar
roof	roof
fodder	fodder
byway	byways
dervorin	dervorin
often	often
bywat	bywater
orc-chieftain	orc-chieftain
tough	tough
room	room
otherwis	otherwise
angband	angband
romp	romp
nan	nan
nap	napping
nar	nar
distant	distant
hawthorn	hawthorn
through	through
frozen	frozen
tarri	tarried
nai	nai
skinni	skinny
childless	childless
galadhon	galadhon
tuckborough	tuckborough
friski	frisky
circul	circulated
rememb	remember
layer	layer
appar	apparently
equal	equally
destini	destiny
nay	nay
capit	capital
marbl	marbles
textur	texture
whenc	whence
longwis	longwise
honey	honey
nori	nori
rank	ranks
thrbin	thrbin
hind	hind
invad	invaded
noro	noro
rang	rang
daisi	daisies
hing	hinge
hill	hill
invas	invasion
shouldst	shouldst
hilt	hilt
grasshopp	grasshopper
rosi	rosie
ramp	ramp
rose	rose
diddl	diddle
yammer	yammered
lifeless	lifeless
arriv	arrived
knoll	knoll
upthrust	upthrusting
clamour	clamouring
distast	distaste
rescu	rescue
courag	courage
broad	broad
fungus	fungus
rori	rory
someth	something
daresay	daresay
encircl	encircling
noth	nothing
helpless	helpless
rape	rape
note	note
water	water
faith	faith
privat	privately
nourish	nourishing
unwarili	unwarily
unknown	unknown
prais	praise
empti	empty
fiddl	fiddle
squelch	squelching
marksmen	marksmen
omit	omit
greyflood	greyflood
omin	ominous
nose	nose
patch	patches
interwoven	interwoven
faintest	faintest
where	where
subdu	subdued
afresh	afresh
rare	rare
fraught	fraught
wonder	wonder
proceed	proceeds
none	none
medicin	medicine
resin	resin
clatter	clatter
hire	hiring
blackberri	blackberry
scroll	scrolls
tumbl	tumbled
cedar	cedar
countless	countless
helminga	helmingas
appli	apply
watchwood	watchwood
envi	envying
overshadow	overshadowed
restless	restless
rainbow	rainbow
noos	noose
bodiless	bodiless
infal	infalls
noon	noon
marin	mariner
galadhrim	galadhrim
expedit	expedition
fourteenth	fourteenth
rath	rath
sprung	sprung
unfair	unfair
estrang	estranged
rate	rate
squawk	squawk
below	below
belov	beloved
muzzl	muzzle
rove	roving
quagmir	quagmires
condit	conditions
undervalu	undervalued
resid	residence
roun	roun
rous	rouse
spokesman	spokesman
hint	hint
problem	problem
somewh	somewher
rout	routed
unbraid	unbraided
omen	omen
prank	pranks
pantri	pantry
rash	rash
tender	tender
sirannon	sirannon
pranc	prancing
nook	nooks
daili	daily
spread	spread
excit	excitement
embrasur	embrasures
devilri	devilry
faint	faint
snuffl	snuffling
treatment	treatment
scar	scar
hasten	hasten
hide	hiding
enlarg	enlarged
aisl	aisle
year	years
reson	resonant
valar	valar
shamefac	shamefaced
uneaten	uneaten
unburden	unburdened
elvenhom	elvenhome
bottom	bottom
waterval	watervales
endang	endanger
edgewis	edgewise
sticki	sticky
east-mountain	east-mountains
slain	slain
magnif	magnific
chase	chase
restrain	restrained
hyacinth	hyacinths
annon	annon
slower	slower
upstream	upstream
chasm	chasms
underharrow	underharrow
rougher	rougher
elenath	elenath
annoy	annoyed
cirdan	cirdan
overlord	overlord
picket	pickets
mound	mounds
furri	furry
admir	admirers
admit	admit
halfelven	halfelven
charm	charming
willow-tr	willow-tre
mount	mount
charg	charge
basket	basket
nut	nut
ammen	ammen
horsebre	horsebreed
picker	pickers
hindranc	hindrance
garden	garden
reflect	reflection
conscienc	conscience
nur	nurs
progress	progress
doughtiest	doughtiest
angren	angren
forefing	forefinger
lantern	lanterns
counsellor	counsellors
Monday	Monday
champ	champ
ettenmoor	ettenmoors
waylay	waylay
barest	barest
nastier	nastier
mouth	mouth
grovel	grovelling
unruffl	unruffled
forest	forest
chalk	chalk
throttl	throttle
forese	foresee
quarter	quarter
celebrnan	celebrnan
alongsid	alongside
attir	attired
splendor	splendor
dirti	dirty
someon	someone
airi	airy
smjagol	smjagol
chant	chanting
consum	consumed
overlook	overlooked
thranduil	thranduil
unhor	unhors
unhop	unhopeful
sprinkl	sprinkle
heatherto	heathertoes
mourn	mourning
slant	slanting
verg	verge
general	general
veri	very
generat	generations
vers	verses
pretend	pretended
pretenc	pretence
scan	scan
chang	change
high	high
reduc	reduced
admitt	admittance
burdensom	burdensome
daylight	daylight
chanc	chance
escarp	escarpment
jovial	jovial
diffus	diffused
mill	mill
milo	milo
milk	milk
slowli	slowly
mile	miles
angrier	angrier
nod	nodded
nob	nob
soldieri	soldiery
noak	noakes
gleeful	gleeful
noi	nois
noo	noos
teeth	teeth
not	not
blench	blench
nor	nor
now	now
concour	concours
myself	myself
gabbl	gabbled
engross	engrossing
shield	shield
nobl	noble
littl	little
realli	really
thrawn	thrawn
plead	pleading
mina	minas
unguard	unguarded
consid	considered
foolish	foolish
pleas	please
mine	mine
mind	mind
wetter	wetter
smother	smother
aranion	aranion
slash	slashed
landrov	landroval
vent	vents
fortnight	fortnight
keeper	keeper
process	process
didst	didst
ungrat	ungrateful
chair	chair
beggar	beggar
chain	chain
pheriain	pheriain
fascin	fascinated
lowest	lowest
sturdili	sturdily
unansw	unanswered
acquir	acquired
consol	console
shred	shred
belong	belong
slate	slate
battlement	battlement
beregond	beregond
cower	cowered
splendid	splendid
realiz	realize
charcoal	charcoal
throughout	throughout
uppermost	uppermost
semicircl	semicircle
wherefor	wherefore
saucepan	saucepan
yelp	yelp
aiya	aiya
proudest	proudest
sickl	sickle
yell	yell
crimson	crimson
thick	thick
rankl	rankle
erkenbrand	erkenbrand
known	known
breeland	breelanders
slave	slaves
bringer	bringer
longhol	longholes
thiev	thieving
skeleton	skeleton
veil	veil
vein	veins
mire	mires
tackl	tackle
besieg	besieged
mirk	mirk
quickest	quickest
travers	traversing
horse-lord	horse-lords
chafe	chafes
nib	nibs
greatest	greatest
whistl	whistled
thiel	thiel
thien	thien
chaer	chaered
mumbl	mumbled
misl	misled
shoulder	shoulder
acknowledg	acknowledge
thief	thief
ordain	ordained
nin	nin
miss	miss
mist	mist
total	total
cavalri	cavalry
twitch	twitch
deciph	decipher
mountain	mountains
fret	fretting
nindalf	nindalf
higher	higher
unwatch	unwatched
northward	northwards
free	free
incbnus	incbnus
unearth	unearthly
search	searched
blacker	blacker
snare	snare
blacken	blackened
snarl	snarled
parent	parental
sapl	sapling
oho	oho
apart	apart
veer	veered
marvel	marvel
morrowless	morrowless
unnecessari	unnecessary
akin	akin
casket	casket
thyme	thymes
umaryo	umaryo
pois	poised
thigh	thighs
comrad	comrade
oil	oil
river-sid	river-side
warmer	warmer
assuag	assuaged
could	could
arathorn	arathorn
kingsfoil	kingsfoil
interf	interfering
halfast	halfast
sand	sand
sang	sang
frbr	frbr
ploughman	ploughman
wrath	wrath
receiv	received
aveng	avenged
midg	midges
translat	translation
sank	sank
greyer	greyer
interv	intervals
ancientri	ancientry
inland	inland
unmark	unmarked
avenu	avenue
blizzard	blizzard
fray	fray
milder	milder
mockeri	mockery
tasti	tasty
snowstorm	snowstorms
111	111
chieftain	chieftains
same	same
heron	herons
maraud	marauding
suspicion	suspicion
slight	slightly
pole	poles
saradoc	saradoc
depriv	deprived
bombur	bombur
sindanuriello	sindanuriello
moonri	moonris
think	thinking
stink	stinks
abash	abashed
sting	sting
stint	stinted
odo	odo
shirelik	shirelike
dusti	dusty
sale	sale
cough	coughing
poke	poking
dissolv	dissolved
dusst	dusst
outflung	outflung
odd	odd
tarlang	tarlang
thine	thine
untrusti	untrusty
thing	thing
salt	salt
pound	pounding
thwinl	thwinl
footpath	footpath
sake	sake
today	today
disea	diseas
dishonour	dishonoured
pong	pong
whomsoev	whomsoever
hurray	hurray
wrapp	wrapp
poni	pony
Saturday	Saturday
releas	released
pond	pond
130	130
outpac	outpaced
flick	flicked
still	still
oft	oft
djorwin	djorwine
recal	recalled
unhappili	unhappily
off	off
magnific	magnificence
bounder	bounders
flaxen	flaxen
curl	curling
cours	course
court	courts
curb	curb
cure	cure
oncom	oncoming
huger	huger
encourag	encouraged
curs	cursing
annyn	annyn
curv	curves
heath	heath
impervi	impervious
unquench	unquenchable
heart	hearts
starkhorn	starkhorn
onli	only
third	third
detest	detested
baranor	baranor
silmaril	silmaril
upright	upright
butterfli	butterflies
comfortless	comfortless
calenhad	calenhad
snakelik	snakelike
abandon	abandon
allay	allay
hurrah	hurrah
foothold	foothold
meantim	meantime
pollut	polluted
meriadoc	meriadoc
bumpkin	bumpkin
moment	moment
uruk-hai	uruk-hai
sheepish	sheepish
sawn	sawn
flammif	flammifer
enhearten	enheartening
trove	trove
heard	heard
tunic	tunic
emyn	emyn
buch	buch
buck	buck
oak	oak
relent	relent
pressur	pressure
frja	frja
fallow	fallow
oar	oar
cloudyhead	cloudyhead
oat	oat
glossi	glossy
differ	difference
reced	receded
thangorodrim	thangorodrim
passabl	passable
vouch	vouch
count	count
save	saved
unmask	unmasked
anxieti	anxiety
mice	mices
unexplor	unexplored
harpstr	harpstring
altern	alternated
flint	flint
pock	pocked
oast	oast
fling	fling
islet	islet
sauc	sauce
duski	dusky
chubb	chubbs
horseflesh	horseflesh
clench	clenched
stifl	stifling
nether	nether
stiff	stiff
djagol	djagol
deathless	deathless
frod	frod
unprais	unpraised
stick	stick
frog	frog
earnest	earnest
coupl	couple
writhen	writhen
from	from
unprai	unprais
network	network
trusti	trusty
stealest	stealest
mould	moulded
linger	lingered
poet	poet
westfarth	westfarthing
overpow	overpowering
prevail	prevailed
heavi	heavy
discours	discourse
perfunctori	perfunctory
between	between
edain	edain
morgulduin	morgulduin
recit	reciting
avert	averted
intens	intensely
intent	intently
oath	oath
fount	fount
sarn	sarn
hidden	hidden
mason	mason
signpost	signpost
intend	intended
found	found
radbug	radbug
cuio	cuio
arrow	arrows
crebain	crebain
servic	service
rage	raged
slayer	slayer
recov	recovered
connexion	connexion
juici	juicy
saith	saith
unescap	unescapable
dromund	dromunds
legion	legions
excus	excuse
bereft	bereft
stouter	stouter
honor	honor
gobbl	gobbling
involv	involved
kitchen	kitchen
scanti	scanty
supper	supper
owl	owl
warmth	warmth
own	own
woodland	woodland
split	split
complain	complain
dwalin	dwalin
face	face
dispo	dispos
wheel	wheels
outlandish	outlandish
anoth	another
melilot	melilot
possess	possess
fabl	fabled
gildor	gildor
belli	belly
invit	invited
jewelleri	jewellery
fade	faded
ginger	gingerly
happi	happy
invis	invisible
throati	throaty
cull	culled
noman	noman
speedili	speedily
fact	fact
Novemb	November
mightili	mightily
wheew	wheew
prompt	promptings
footsor	footsore
minor	minor
consequ	consequence
darken	darkened
marsh	marshes
exclam	exclamation
reminisc	reminiscences
alley	alley
livelihood	livelihood
uniqu	uniquely
oth	oth
fallen	fallen
certainti	certainty
denethor	denethor
pucker	puckered
rummag	rummaging
rall	rall
rotten	rotten
flicker	flickered
lakesid	lakeside
arnach	arnach
tater	taters
poison	poison
wreath	wreath
lugdush	lugdush
shiver	shivering
marri	married
inform	information
shutter	shutters
darker	darker
foreign	foreign
raid	raid
weld	welded
tube	tube
toneless	toneless
well	well
knight	knights
owe	owe
moistur	moisture
wondrous	wondrous
rais	raised
rail	rail
droop	drooping
tauremorna	tauremorna
rain	raining
sunbeam	sunbeams
warworthi	warworthy
waterf	waterfal
consent	consent
mymak	mymak
disus	disused
suppli	supply
tuck	tucked
snaga	snaga
ove	ove
waterv	waterval
elvish	elvish
belik	belike
aback	aback
wateri	watery
our	our
out	out
recept	reception
uneasi	uneasy
saddlebow	saddlebow
uttermost	uttermost
sober	sober
languag	language
went	went
yassen	yassen
cover	covered
foodless	foodless
fail	failing
splay	splayed
covet	covets
mightier	mightier
enclo	enclos
belch	belch
cricket	cricket
hideous	hideous
calcul	calculations
unint	unintent
underworld	underworld
deafen	deafening
fair	fair
deafer	deafer
pouch	pouch
ooz	ooze
assail	assailed
motto	motto
snail	snails
durst	durst
orc	orcs
ground	ground
ore	ore
wept	wept
cargo	cargo
ori	ori
tuft	tufted
union	union
stybba	stybba
sometim	sometimes
bereav	bereaved
102	102
whenev	whenever
sorrowless	sorrowless
foeman	foeman
recess	recesses
suppos	supposed
crystal	crystal
heathland	heathland
snake	snakes
afterthought	afterthought
orb	orb
vermin	vermin
allud	allude
fall	fall
habergeon	habergeon
allur	allured
whisker	whiskers
fals	false
old	old
township	township
discomfit	discomfiting
promis	promised
tricksi	tricksy
churn	churning
rack	racked
subtl	subtle
race	race
isildur	isildur
fame	fame
were	were
ember	embers
mingl	mingled
glisten	glistens
doorstep	doorstep
roofless	roofless
compani	company
tune	tune
fang	fangs
encompass	encompassed
disord	disordered
west	west
untutor	untutored
brandish	brandished
overboard	overboard
allow	allow
caution	caution
onc	once
drogo	drogo
greenfield	greenfields
one	one
unjust	unjust
carca	carcas
allot	allotted
recent	recent
woodi	woody
moonless	moonless
perfect	perfect
eleventy-on	eleventy-one
nicknam	nickname
udan	udan
nonetheless	nonetheless
inspir	inspiration
goldwin	goldwine
belat	belated
channel	channel
neldor	neldor
barb	barbed
insol	insolence
clump	clumps
asund	asunder
particular	particular
foundat	foundations
buckler	buckler
sundri	sundry
elven-lor	elven-lore
sparkler	sparklers
dotard	dotard
barn	barn
refer	referring
tendenc	tendency
bark	barked
woken	woken
barg	barges
lordship	lordship
bare	bare
bard	bardings
shown	shown
wide	wide
clung	clung
tail	tail
carrock	carrock
twelv	twelve
unfold	unfolding
miruvor	miruvor
wealth	wealth
fawn	fawning
underground	underground
smooth	smooth
wick	wicked
depart	departed
intermin	interminably
mixtur	mixture
undisturb	undisturbed
patient	patiently
marjoram	marjorams
bath	bathe
member	members
refil	refilled
waver	wavering
reproach	reproachful
incur	incurable
comfort	comfortably
base	bases
bask	basking
ralli	rallied
gateway	gateway
ditch	ditch
out-they	out-they
wellforg	wellforged
samwis	samwise
ancalagon	ancalagon
uncloak	uncloaked
fate	fate
bane	bane
tang	tang
kiss	kissing
outmatch	outmatching
band	band
thengel	thengel
dreamlik	dreamlike
friendship	friendship
brighten	brightened
bank	bank
brighter	brighter
bang	bang
founder	foundered
alik	alike
uprush	uprushing
creas	creased
grotto	grotto
creak	creaking
togeth	together
unfinish	unfinished
cream	cream
tame	tamed
aliv	alive
deathlik	deathlike
footstool	footstool
fast	fast
strove	strove
incom	incoming
alli	allied
feebli	feebly
sturdiest	sturdiest
fare	fare
afloat	afloat
tintall	tintalll
lad	lad
farm	farm
lag	lagged
tale	tales
lal	lal
creek	creek
lap	lap
fars	farse
tall	tall
talk	talk
straggler	stragglers
law	law
bombadillo	bombadillo
saddest	saddest
constant	constantly
april	april
lay	lay
thousand	thousand
anniversari	anniversary
take	take
pendant	pendants
aloft	aloft
stalwart	stalwart
freshet	freshet
tart	tart
elendil	elendil
tween	tweens
fresher	fresher
tark	tarks
freshen	freshened
uncanni	uncanny
carri	carried
stroke	stroked
convey	conveyed
widest	widest
conver	convers
garth	garth
neldoreth	neldoreth
torment	tormented
newcom	newcomers
convex	convex
dispel	dispelled
wile	wiles
wild	wild
unwant	unwanted
bustl	bustle
tighfield	tighfield
wilt	wilted
shoot	shoot
creep	creep
will	will
almo	almo
shook	shook
apron	apron
virtual	virtually
pardon	pardon
shore	shore
unsatisfi	unsatisfied
starlight	starlight
bandag	bandage
dungeon	dungeons
enshroud	enshrouded
melodi	melodies
linhir	linhir
fiber	fiber
cleav	cleave
sackville-baggin	sackville-baggins
clear	cleared
short	shortly
clean	clean
undoubt	undoubtedly
strawberri	strawberries
shorn	shorn
barrowfield	barrowfield
stumbl	stumbling
unthrottl	unthrottled
firmament	firmament
bloodshot	bloodshot
despit	despite
workmanship	workmanship
despis	despise
master	master
stroll	stroll
durin	durin
lumpi	lumpy
alon	alone
leaflock	leaflock
devour	devoured
constrain	constrained
marriag	marriage
morannon	morannon
dragon	dragon
ranger	ranger
unnerv	unnerved
exert	exerting
smear	smeared
westerness	westernesse
socket	sockets
unwari	unwary
gorgoroth	gorgoroth
sunder	sundered
loyal	loyal
argument	argument
victual	victuals
revolt	revolts
minut	minute
revolv	revolved
matur	mature
famili	families
fatherless	fatherless
sunland	sunlands
taur	taur
lumin	luminous
depth	depths
condemn	condemned
stonework	stonework
strong	strong
stiffen	stiffened
birdlik	birdlike
patienc	patience
rabbit	rabbits
trailer	trailer
pelargir	pelargir
werewolv	werewolves
livid	livid
seal	seal
firienwood	firienwood
grappl	grappling
dwimorden	dwimordene
fissur	fissure
task	task
tast	taste
blazon	blazoned
wife	wife
tobold	tobold
cleft	cleft
surer	surer
also	also
shout	shouting
awhil	awhile
hornburg	hornburg
slouch	slouching
distribut	distributed
behead	beheaded
hearti	hearties
hearth	hearth
hung	hung
sear	seared
seat	seat
adopt	adopted
dorthonion	dorthonion
hunt	hunt
along	along
gnash	gnashing
inscrib	inscribed
audibl	audibly
lop	lop
loo	loos
lor	lor
gnarl	gnarled
knuckl	knuckled
log	log
inward	inwards
sunday	sunday
los	los
rearward	rearward
lot	lot
blotch	blotched
sourc	source
fairer	fairer
low	low
compil	compiled
aloof	aloof
sedg	sedge
strode	strode
daunt	daunted
disprov	disprove
captain	captain
ugli	ugly
territori	territory
otherwi	otherwis
kingdom	kingdom
southlinch	southlinch
ettendal	ettendales
waterfal	waterfall
crept	crept
feeler	feelers
nineteen	nineteen
holden	holden
seed	seed
keener	keener
aught	aught
leisur	leisurely
seer	seer
back	back
knowest	knowest
seen	seen
singular	singular
seem	seemed
seek	seeks
troth	troth
either	either
angbor	angbor
south	south
carrots	carrotses
suppress	suppressed
confeder	confederates
trespass	trespass
wrack	wrack
frontier	frontier
lunch	lunch
causeway	causeway
lug	lugged
courtesi	courtesy
drunken	drunkenly
devious	deviously
ironmongeri	ironmongery
dauntless	dauntless
jingl	jingled
select	selection
deeping-stream	deeping-stream
hobbit-child	hobbit-child
render	rendering
boggi	boggy
draggl	draggled
whoa	whoa
sound	sound
whom	whom
crest	crests
cress	cresses
dahrar	dahrar
ruffl	ruffled
laita	laita
osgiliath	osgiliath
matriarch	matriarch
rumboom	rumboom
hulk	hulk
vilya	vilya
refus	refuse
fortun	fortune
slush	slush
troop	troop
straddl	straddled
grandmoth	grandmother
inflow	inflow
scyth	scythe
refug	refuge
thrust	thrust
futur	future
regular	regular
wriggl	wriggling
arrang	arranged
erela	erelas
achiev	achieve
threshold	threshold
wearier	wearier
hump	humps
hitch	hitch
hearken	hearken
seiz	seized
person	personally
inflam	inflamed
cackl	cackled
huff	huff
goldenhair	goldenhaired
tree	trees
egladil	egladil
greedi	greedy
pour	pouring
downright	downright
snugger	snugger
disfigur	disfigured
himsel	himsel
extra	extra
jolli	jolly
entreat	entreat
forefront	forefront
prepar	preparing
hugo	hugo
curtain	curtains
unheed	unheeding
huge	huge
bait	bait
onslaught	onslaught
disput	dispute
suffici	sufficient
glove	gloves
countrymen	countrymen
bain	bain
ufthak	ufthak
topmost	topmost
prayer	prayer
questio	questio
prickl	prickle
beheld	beheld
bake	baked
self	self
tirion	tirion
pose	posed
remorseless	remorseless
garbl	garbled
unheat	unheated
sell	sell
selv	selves
dishonor	dishonors
uncloud	unclouded
aloud	aloud
uncertain	uncertain
foretold	foretold
ball	ball
post	posts
bale	baleful
n't	n't
let	let
inset	inset
headfirst	headfirst
storeh	storehous
compos	composed
bald	bald
princedom	princedom
leg	legs
prison	prison
lee	lee
led	led
troll	troll
storey	storey
send	send
inexhaust	inexhaustible
unwrap	unwrapped
firth	firth
drawer	drawer
skulk	skulking
skull	skulls
badg	badges
sent	sent
bade	bade
middle-earth	middle-earth
scrubbi	scrubby
overrid	override
sens	sense
uplift	uplifted
unfortun	unfortunately
herald	herald
statur	stature
greener	greener
stewardship	stewardship
trap	trap
wingfoot	wingfoot
junior	juniors
compul	compuls
sullen	sullen
season	season
untend	untended
tray	tray
lantar	lantar
pork	pork
comput	computed
match	match
pore	pored
mossi	mossy
aright	aright
adjoin	adjoining
bubbl	bubbling
wearili	wearily
headach	headaches
credibl	credible
pool	pools
safer	safer
midsumm	midsummer
grimslad	grimslade
jailor	jailor
redoubl	redoubled
lit	lit
detect	detect
lip	lips
lim	lim
poor	poor
spideri	spidery
bracegirdl	bracegirdle
storag	storage
east-gat	east-gate
tirith	tirith
around	around
lid	lid
anurien	anurien
yule	yule
instead	instead
clamber	clambered
dispos	disposed
spider-form	spider-form
insid	inside
first	first
lie	lie
waste-land	waste-lands
evict	evicted
backarapp	backarappers
eorl	eorl
scra	scra
threat	threat
intol	intoler
mknu	mknu
challeng	challenge
triumph	triumph
hobbit-talk	hobbit-talk
trot	trotting
whichev	whichever
parcel	parcels
stormi	stormy
shathyr	shathyr
thread	threaded
brow	brows
tremor	tremor
frantic	frantically
irrevoc	irrevocable
torch	torches
trod	trod
out-compani	out-companies
sleev	sleeve
gees	geese
fishi	fishy
sleek	sleek
sleep	sleep
amid	amid
starri	starry
persua	persuas
outrid	outriders
slumber	slumber
upstair	upstairs
whitfoot	whitfoot
quieter	quieter
fundin	fundin
thrakatulyk	thrakatulyk
pledg	pledge
sledg	sledge
mad	madly
bristl	bristling
mae	mae
leavi	leavi
map	maps
lammen	lammen
bargain-if	bargain-if
scof	scoffed
mar	mar
man	man
petti	petty
sounder	sounder
may	may
mat	mats
wellnigh	wellnigh
startl	startled
grimmer	grimmer
what	what
harad	harad
silvan	silvan
least	least
legendari	legendary
spite	spite
khazvd	khazvd
conduct	conduct
blindfold	blindfold
unslain	unslain
gloom	gloom
seldom	seldom
scum	scum
gust	gust
reward	reward
ramma	rammas
outlook	outlook
unfamiliar	unfamiliar
thursday	thursday
grimbold	grimbold
bedsid	bedside
learn	learning
burst	burst
grumbl	grumbling
gush	gushing
scud	scudded
machin	machines
intoler	intolerable
green-whit	green-white
saxifrag	saxifrages
youngster	youngster
outrag	outraged
brui	bruis
chosen	chosen
grishnbkh	grishnbkh
met	met
mew	mew
outran	outran
ident	identity
bofur	bofur
mer	mer
mem	mem
breaker	breaker
men	men
trip	trip
trim	trimming
hardi	hardy
endur	endure
leapt	leapt
uncomfort	uncomfortable
gulli	gullies
upward	upwards
lurien	lurien
suspen	suspens
glori	glory
ruinous	ruinous
persuas	persuasion
whim	whim
leechcraft	leechcraft
whin	whin
persuad	persuaded
whiter	whiter
repay	repay
whiten	whitening
foreleg	forelegs
unwound	unwound
whip	whip
djor	djor
metalwork	metalwork
recreant	recreant
charact	character
eboni	ebony
absolut	absolute
toast	toasted
bogey	bogey
silverlod	silverlode
nobodi	nobody
advanc	advancing
enclos	enclose
armouri	armouries
wright	wrights
castl	castle
fashion	fashioned
nimbrethil	nimbrethil
rbrum	rbrum
spire	spire
iron-shod	iron-shod
southward	southwards
henceforth	henceforth
lightless	lightless
collaps	collapsed
reluct	reluctance
inscript	inscription
true	true
snuffler	snufflers
appledor	appledore
endorenna	endorenna
amon	amon
durthang	durthang
downhil	downhill
overrun	overrun
sluic	sluice
erebor	erebor
hedgehog	hedgehog
spike	spike
scion	scion
evilli	evilly
despatch	despatched
nuisanc	nuisance
gull	gulls
when	when
gulf	gulf
neekerbreek	neekerbreekers
credit	credit
live	live
aglar	aglar
pedest	pedestal
sackvill	sackville
spill	spilled
horsethiev	horsethieving
inherit	inherited
sammath	sammath
aiglo	aiglos
liquid	liquid
nimrodel	nimrodel
amus	amused
greyham	greyhame
compar	compared
compen	compens
compet	competent
lith	lithe
truant	truants
compel	compelling
northernmost	northernmost
truesilv	truesilver
shroud	shrouded
slung	slung
suspect	suspected
crevic	crevices
hush	hush
slunk	slunk
guis	guise
spine	spines
spini	spiny
silver	silver
whew	whew
liss	lisse
oliv	olive
list	lists
whet	whetting
deneth	deneth
guid	guides
abund	abundant
hurt	hurt
April	April
easter	easterly
slump	slumped
hurl	hurled
horrifi	horrified
eighteen	eighteen
clippeti	clippety
leafi	leafy
mr.	mr.
cordial	cordial
petal	petals
entmoot	entmoot
celo	celos
shadi	shady
forbod	forbodes
vener	venerable
bushi	bushy
cell	cell
mop	mop
downcast	downcast
mow	mowing
mor	mor
safekeep	safekeeping
leagu	leagues
ennorath	ennorath
chorus	chorus
stiffli	stiffly
conflict	conflicting
shade	shades
waterway	waterways
increas	increased
silent	silently
simpli	simply
frank	frankness
ceil	ceiling
mrs	mrs
silenc	silence
footstep	footstep
nibbl	nibbled
holli	holly
prostrat	prostrate
dimholt	dimholt
innumer	innumerable
misconstru	misconstruing
thennath	thennath
morimait	morimaite
repli	reply
valinor	valinor
shaft	shaft
frjalaf	frjalaf
tbrienna	tbrienna
careless	careless
brag	brag
dwindl	dwindled
husbandmen	husbandmen
molten	molten
trench	trench
springtim	springtime
intak	intake
confirm	confirm
asleep	asleep
kick	kicked
bray	braying
busili	busily
starlit	starlit
midmost	midmost
harsh	harsh
jomer	jomer
clumsi	clumsy
brat	brats
bicker	bickering
mug	mug
fenni	fenny
mud	mud
muc	muc
orc-blood	orc-blood
desper	desperate
fenna	fennas
moria	moria
boldest	boldest
follow	follow
famish	famished
shone	shone
stinker	stinker
harri	harry
weigh	weighed
frame	frame
stoutheart	stouthearted
liquor	liquor
weight	weight
windlord	windlord
tankard	tankard
catch	catch
longest	longest
withhold	withhold
scantili	scantily
brandmark	brandmarks
mardil	mardil
furlong	furlong
fifteen	fifteen
toilsom	toilsome
noodl	noodles
globe	globe
fellowship	fellowship
midmorn	midmorning
bred	bred
bandobra	bandobras
gloam	gloaming
begotten	begotten
eviley	evileyed
ivori	ivory
gloat	gloated
reverend	reverend
inten	intens
groundless	groundless
aragorn	aragorn
bree	bree
success	successful
equip	equipped
filthi	filthy
hewn	hewn
venom	venomous
shake	shaking
willi	willie
unneed	unneeded
burden	burdened
brew	brewing
morgul	morgul
flower	flowers
enemi	enemy
duller	duller
fanyar	fanyar
shoal	shoals
upstart	upstart
shale	shale
ambl	amble
bargain	bargain
whortl	whortle
without	without
largest	largest
shall	shall
diari	diary
cede	ceded
unkno	unkno
shalt	shalt
water-sid	water-side
shaggi	shaggy
amaz	amazement
imladri	imladris
frail	frail
hobbits	hobbitses
trenchlik	trenchlike
smell	smell
shame	shame
ceas	ceased
ninnyhamm	ninnyhammer
gondolin	gondolin
munch	munched
king	kings
oddment	oddments
kind	kind
kine	kine
windowless	windowless
command	command
smelt	smelt
reput	reputedly
tinder	tinder
sincer	sincerity
min	min
mil	mil
brim	brim
cater	catering
fissh	fisshes
mix	mixed
shank	shank
numberless	numberless
tabl	table
mid	mid
sky-field	sky-fields
crunchabl	crunchable
ppps	ppps
archeri	archery
kill	killed
password	password
ithildin	ithildin
gear	gear
woman	woman
forbear	forbear
power	power
bonfir	bonfire
shelob	shelob
greenway	greenway
suppo	suppos
symbol	symbols
suppl	supple
shape	shapely
stumpi	stumpy
arvedui	arvedui
warehous	warehouses
faggot	faggot
onodrim	onodrim
aldaluml	aldaluml
undefend	undefended
filter	filtered
khazad	khazad
wouldst	wouldst
share	share
shard	shard
denser	denser
whimper	whimpering
unpleas	unpleasant
busier	busier
discourtesi	discourtesy
steadfast	steadfast
pinewood	pinewoods
sharp	sharp
untroubl	untroubled
women	women
shock	shock
overmast	overmastered
vanquish	vanquished
justic	justice
harper	harpers
